AGTAACGGGGCAGCACCTG -> GTAACGGGGCAGCACCTGC
AACCCTAGCGTCCGATAAA -> ACCCTAGCGTCCGATAAAT
GGGACGCTCCTCAATAAAT -> GGACGCTCCTCAATAAATG
GCTCTGACCACCGGCCTTA -> CTCTGACCACCGGCCTTAG
TATGGGGCAGGACAAATGC -> ATGGGGCAGGACAAATGCT
TAGCCAAATCCGACGCCTA -> AGCCAAATCCGACGCCTAG
CCAAGTCATGGGTAAGCCT -> CAAGTCATGGGTAAGCCTG
TTTTTGTTGTCTCGTCCGT -> TTTTGTTGTCTCGTCCGTG
GTGTCACTTGGTAGTACGC -> TGTCACTTGGTAGTACGCC
AAGTAGACTTTTTGAACGA -> AGTAGACTTTTTGAACGAC
CACACACGTGGTTACGTCC -> ACACACGTGGTTACGTCCT
AGACCAGGGCGGTACGGGT -> GACCAGGGCGGTACGGGTG
ACGTGGTTACGTCCTCCTC -> CGTGGTTACGTCCTCCTCG
CGCTGGAACAAATGGAGTT -> GCTGGAACAAATGGAGTTG
TCCCGCCCTACGATCTGTG -> CCCGCCCTACGATCTGTGT
AGCAACCCTAGCGTCCGAT -> GCAACCCTAGCGTCCGATA
GGGATACCGATGGACGCCA -> GGATACCGATGGACGCCAT
GAGCCGAGTTACCAGAATC -> AGCCGAGTTACCAGAATCG
GATGGACGCCATCTCATAA -> ATGGACGCCATCTCATAAC
ATATGCCCTGCCGGAGAGA -> TATGCCCTGCCGGAGAGAC
TTCGGAGATTCTTGCGGAA -> TCGGAGATTCTTGCGGAAT
AATGGAGTTGTCTCAAGCA -> ATGGAGTTGTCTCAAGCAG
AGTAGATATGGGCAGCCAC -> GTAGATATGGGCAGCCACG
CCCGCGTATGGGGCAGGAC -> CCGCGTATGGGGCAGGACA
TGCGATTTTTAGTCAGTTC -> GCGATTTTTAGTCAGTTCG
TCAGTGGCATGCAAGGCTT -> CAGTGGCATGCAAGGCTTG
GATCGACATTCTACATAAA -> ATCGACATTCTACATAAAG
AATTTCGCCCTTCAGTGGG -> ATTTCGCCCTTCAGTGGGC,ATTTCGCCCTTCAGTGGGG
GACGAAAGCGTCTGCGATT -> ACGAAAGCGTCTGCGATTA
GCCTGAAGTCTCCCTCTGT -> CCTGAAGTCTCCCTCTGTC
CTTAGAACAAATGGAGTTG -> TTAGAACAAATGGAGTTGT
TCTACATAAAGTCAGTTAC -> CTACATAAAGTCAGTTACC
CGACGGCTTCTGCGACGAT -> GACGGCTTCTGCGACGATG
TAGCGCTTATCGCGGGTGT -> AGCGCTTATCGCGGGTGTC
CCGATCAGTTTGGCCCTCC -> CGATCAGTTTGGCCCTCCG
CGGGTGTACGCACTTTTCG -> GGGTGTACGCACTTTTCGC
GAGTGGCCCCTCCCACCCC -> AGTGGCCCCTCCCACCCCT
AGAGCGAATCAACCACAGT -> GAGCGAATCAACCACAGTT
CAGTTCATCAATGCACACG -> AGTTCATCAATGCACACGC
TCTGTCGTGAACTCATTCG -> CTGTCGTGAACTCATTCGC
AAGACCTGGGATGTACAAT -> AGACCTGGGATGTACAATA
CTGACCACCGGCCTTAGAA -> TGACCACCGGCCTTAGAAT
ACAGTCCGACGGACACGAA -> CAGTCCGACGGACACGAAC
TGGTGAACAACTACAACAG -> GGTGAACAACTACAACAGT
CATGAAAGACAAGCACACT -> ATGAAAGACAAGCACACTG
CCCCTGCTGGGAGTATGTC -> CCCTGCTGGGAGTATGTCC
AGACATGATCGCCGCGACG -> GACATGATCGCCGCGACGC
GGTCACCCAATATTGCGAT -> GTCACCCAATATTGCGATT
TATGCTATTCCGCAGTGGC -> ATGCTATTCCGCAGTGGCC
CCTTGCCGATACAGCTCCA -> CTTGCCGATACAGCTCCAC
GCTGACGGTCAACAACTGT -> CTGACGGTCAACAACTGTG
GTATGTGGTAACCACCATT -> TATGTGGTAACCACCATTA
AGGCGACGAAAGCGTCTGC -> GGCGACGAAAGCGTCTGCG
CTCCTCGGTGTAATTGACT -> TCCTCGGTGTAATTGACTT
CCGTTGTCTCGCCCGCGTA -> CGTTGTCTCGCCCGCGTAT
CATGGGTAAGCCTGAAGTC -> ATGGGTAAGCCTGAAGTCT
TGATCGCCGCGACGCGGAG -> GATCGCCGCGACGCGGAGG
TGGTGCCGCAAGTAGATAC -> GGTGCCGCAAGTAGATACC
CATTAAGTAAATTCCAGCC -> ATTAAGTAAATTCCAGCCA
TCAAACAAGATTAAGAGCA -> CAAACAAGATTAAGAGCAC
AACTGTGCTCCTTTTTTTG -> ACTGTGCTCCTTTTTTTGT
ATACGTGCAGCCGCCCGAG -> TACGTGCAGCCGCCCGAGT
GGCAAGTAACGGGGCAGCA -> GCAAGTAACGGGGCAGCAC
TGGCTGACGGTCAACAACT -> GGCTGACGGTCAACAACTG
TCAATGACCCGTTTTTGAG -> CAATGACCCGTTTTTGAGG
GAATCGACGCTGGAACAAA -> AATCGACGCTGGAACAAAT
GTAAGCCTGAAGTCTCCCT -> TAAGCCTGAAGTCTCCCTC
TCGCCCTTCAGTGGTGCCG -> CGCCCTTCAGTGGTGCCGC
ATACAGTGGTAAGCCCACA -> TACAGTGGTAAGCCCACAG
GTATTCAGTACTCAATGGA -> TATTCAGTACTCAATGGAG
GTCCGATAAATAAGACGCA -> TCCGATAAATAAGACGCAA
ATCCGACGCCTAGAGCTCT -> TCCGACGCCTAGAGCTCTG
GCCCTTCAGTGGCATGCAA -> CCCTTCAGTGGCATGCAAG
CTCAATGGAGGCGTCAGTA -> TCAATGGAGGCGTCAGTAA
TCTGCGATTAAAGCTGTGG -> CTGCGATTAAAGCTGTGGT
TTATACGTTGTATAGTACA -> TATACGTTGTATAGTACAG
CTCAAGCAGAGTGGAATTT -> TCAAGCAGAGTGGAATTTC
CATTAAAGTCCGCTTACTC -> ATTAAAGTCCGCTTACTCG
AGCACACTGTCATTATATG -> GCACACTGTCATTATATGC
AGGGTCAAGAGACACCGCG -> GGGTCAAGAGACACCGCGG
CCGTCACCCTTCCTGGATG -> CGTCACCCTTCCTGGATGA
CACAGTCCGACGGACACGA -> ACAGTCCGACGGACACGAA
CTACGATCTGTGTCAACGT -> TACGATCTGTGTCAACGTG
CTGGATGACTTGTCGGGTA -> TGGATGACTTGTCGGGTAT
GTTTGGCCCTCCGATTTCG -> TTTGGCCCTCCGATTTCGG
TGCTTAGAACAAATGGAGT -> GCTTAGAACAAATGGAGTT
GGGATGTACAATAGGTTAG -> GGATGTACAATAGGTTAGT
GTCAAACAAGATTAAGAGC -> TCAAACAAGATTAAGAGCA
CGTCTGCGATTAAAGCTGT -> GTCTGCGATTAAAGCTGTG
ACCGCGGCGCATACAGTGG -> CCGCGGCGCATACAGTGGT
CACCAGTCCTCATGAAAGA -> ACCAGTCCTCATGAAAGAC
TGCCCTGCCGGAGAGACAT -> GCCCTGCCGGAGAGACATG
AATTCTGCACGATCGACAT -> ATTCTGCACGATCGACATT
ATGGTTTGGTCACAAGTTA -> TGGTTTGGTCACAAGTTAG
TAGACTTTTTGAACGACAT -> AGACTTTTTGAACGACATG
TAAAGTCAGTTACCAGACC -> AAAGTCAGTTACCAGACCA
TAAAGCTGTGGTTGAGTGG -> AAAGCTGTGGTTGAGTGGC
AGCCAAATCCGACGCCTAG -> GCCAAATCCGACGCCTAGA
AGACAAGCACACTGTCATT -> GACAAGCACACTGTCATTA
GAAAGCGTCTGCGATTAAA -> AAAGCGTCTGCGATTAAAG
TGCCTCGAGCAAAGATGAG -> GCCTCGAGCAAAGATGAGC
ACAAATGGAGTTGTCTGGG -> CAAATGGAGTTGTCTGGGA
AATGAGCAAATGGTGAACA -> ATGAGCAAATGGTGAACAA
TGCTATTCCGCAGTGGCCG -> GCTATTCCGCAGTGGCCGA
AGTTTGGCCCTCCGATTTC -> GTTTGGCCCTCCGATTTCG
AAGTAGATACCGATAGTGT -> AGTAGATACCGATAGTGTA
GACGCCATCTCATAACTAC -> ACGCCATCTCATAACTACG
TAAGTAAATTCCAGCCATT -> AAGTAAATTCCAGCCATTT
ACATGCGTTCCAAAGACCT -> CATGCGTTCCAAAGACCTG
AACGGGGCAGCACCTGCGT -> ACGGGGCAGCACCTGCGTT
GTCTTACGCGGGACCGAAT -> TCTTACGCGGGACCGAATT
TTCTACATAAAGTCAGTTA -> TCTACATAAAGTCAGTTAC
GAGTTGTCTGGGAAGTTAG -> AGTTGTCTGGGAAGTTAGG
AGTGGCCGAACAGAGCCGA -> GTGGCCGAACAGAGCCGAG
TAGAGATGGGTCAAACAAG -> AGAGATGGGTCAAACAAGA
TGAGCACCCTAGCCCCCAA -> GAGCACCCTAGCCCCCAAG
AATGTTTGGTCGGCACTAA -> ATGTTTGGTCGGCACTAAG
TTCGCCCTTCAGTGGGCGC -> TCGCCCTTCAGTGGGCGCA
CAAATGCTTAGAACAAATG -> AAATGCTTAGAACAAATGG
CGTGAACTCATTCGCGGCA -> GTGAACTCATTCGCGGCAC
CCCGTCACCCTTCCTGGAT -> CCGTCACCCTTCCTGGATG
TACGGGTGTACGCACTTTT -> ACGGGTGTACGCACTTTTC
CCCCAAGCTTGTATGTGGT -> CCCAAGCTTGTATGTGGTA
TAGCCCTCAACAACGTCCA -> AGCCCTCAACAACGTCCAA
TATTCAAGTACGGGACGCT -> ATTCAAGTACGGGACGCTC
TGACTAGACGGGTAAAGTC -> GACTAGACGGGTAAAGTCG
AAGCCCACAGTCCTGTCTC -> AGCCCACAGTCCTGTCTCG
CGCAGACTTTGCATGCATA -> GCAGACTTTGCATGCATAC
TGTAGCCCTCAACAACGTC -> GTAGCCCTCAACAACGTCC
AAAAGGTTATACGTTGTAT -> AAAGGTTATACGTTGTATA
GGAGTTGTCTGGGAAGTTA -> GAGTTGTCTGGGAAGTTAG
CTAGGAAAAGGTTATACGT -> TAGGAAAAGGTTATACGTT
AGCTGGTATTGACTAGACG -> GCTGGTATTGACTAGACGG
GAACGGAGGAGCTCAATGA -> AACGGAGGAGCTCAATGAC
AAGAGACACCGCGGCGCAT -> AGAGACACCGCGGCGCATA
AAATGGAGTTGTCTAACGT -> AATGGAGTTGTCTAACGTT
CTATGTGTGATTGAATATA -> TATGTGTGATTGAATATAG
CACAGGGCTTCTCGATCTA -> ACAGGGCTTCTCGATCTAC
GCAATCGGTTTCTAGCCTA -> CAATCGGTTTCTAGCCTAG
AACTCATTCGCGGCACACT -> ACTCATTCGCGGCACACTA
GACGGCTTCTGCGACGATG -> ACGGCTTCTGCGACGATGG
CACGTGGTTACGTCCTCCT -> ACGTGGTTACGTCCTCCTC
ACATTTAAGGGTAAATTAC -> CATTTAAGGGTAAATTACT
CAATAGGTTAGTTGCAGGA -> AATAGGTTAGTTGCAGGAG
CCCTGCTGGGAGTATGTCC -> CCTGCTGGGAGTATGTCCT
GACGGACACGAACAAATGG -> ACGGACACGAACAAATGGA
AGTGGCCCCTCCCACCCCT -> GTGGCCCCTCCCACCCCTG
CAACAAGTACCCCGTCACC -> AACAAGTACCCCGTCACCC
TGTGTCAACGTGCCCTCGG -> GTGTCAACGTGCCCTCGGG
TCTCCCTCTGTCGTGAACT -> CTCCCTCTGTCGTGAACTC
CGCATGCTTGCGCTCATGT -> GCATGCTTGCGCTCATGTG
GACCTGGGATGTACAATAG -> ACCTGGGATGTACAATAGG
CGCAAGGAAACCAAACAGC -> GCAAGGAAACCAAACAGCC
ATGAAAGACAAGCACACTG -> TGAAAGACAAGCACACTGT
GCAGAGTGGAATTTCGCCC -> CAGAGTGGAATTTCGCCCT
CGTCAAGCAATCTGGGCAA -> GTCAAGCAATCTGGGCAAT
ATTCCAGCCATTTTCGGAG -> TTCCAGCCATTTTCGGAGA
GGCGACTATGTGTGATTGA -> GCGACTATGTGTGATTGAA
CAGATAGCCAAATCCGACG -> AGATAGCCAAATCCGACGC
GTGAACTCATTCGCGGCAC -> TGAACTCATTCGCGGCACA
AATGGAGTTGTCTAACGTT -> ATGGAGTTGTCTAACGTTG
CTCTGTCGTGAACTCATTC -> TCTGTCGTGAACTCATTCG
TCTCGTCCGTGTAATCCCA -> CTCGTCCGTGTAATCCCAC
TTCGGTACCACACGTTCGC -> TCGGTACCACACGTTCGCA
ACGGGGCAGCACCTGCGTT -> CGGGGCAGCACCTGCGTTG
TCTCAAGCAGAGTGGAATT -> CTCAAGCAGAGTGGAATTT
CCCACAGTCCTGTCTCGTT -> CCACAGTCCTGTCTCGTTT
GCGCTCATGTGCAACTCTA -> CGCTCATGTGCAACTCTAT
GCATATGCTATTCCGCAGT -> CATATGCTATTCCGCAGTG
TTGCGATTTTTAGTCAGTT -> TGCGATTTTTAGTCAGTTC
CACCGGCCTTAGAATAGAG -> ACCGGCCTTAGAATAGAGC
GCGTATGGGGCAGGACAAA -> CGTATGGGGCAGGACAAAT
GTCCTCCTCGGTGTAATTG -> TCCTCCTCGGTGTAATTGA
GAGCTTGCGTTGTTATAGT -> AGCTTGCGTTGTTATAGTC
GTTGCGCATGCTTGCGCTC -> TTGCGCATGCTTGCGCTCA
CGATAGTGTAGCGGTCACC -> GATAGTGTAGCGGTCACCC
ACGCGGGACCGAATTTCGC -> CGCGGGACCGAATTTCGCC
GTTTCTGTATGAGCACCCT -> TTTCTGTATGAGCACCCTA
GACGCAATGCTAAATAAAC -> ACGCAATGCTAAATAAACA
CGGTTTCTAGCCTAGGAAA -> GGTTTCTAGCCTAGGAAAA
AGCGTCCGATAAATAAGAC -> GCGTCCGATAAATAAGACG
CTGGGAAGTTAGGGAATTT -> TGGGAAGTTAGGGAATTTC
GCCCTCCGATTTCGGCTAG -> CCCTCCGATTTCGGCTAGA
CTTCTCGATCTACAGGGTC -> TTCTCGATCTACAGGGTCA
GATCAAAGAGATGGTTCAC -> ATCAAAGAGATGGTTCACC
CGAGCGGTTGCGATCAAAG -> GAGCGGTTGCGATCAAAGA
TCTGCAATGAGCAAATGGT -> CTGCAATGAGCAAATGGTG
GTATGAGCACCCTAGCCCC -> TATGAGCACCCTAGCCCCC
TTCAGTGGTGCCGCAAGTA -> TCAGTGGTGCCGCAAGTAG
CCTAGGAAAAGGTTATACG -> CTAGGAAAAGGTTATACGT
GGACCGAATTTCGCCCTTC -> GACCGAATTTCGCCCTTCA
GATACCGATGGACGCCATC -> ATACCGATGGACGCCATCT
GCACTTTTCGCTGCGTGGC -> CACTTTTCGCTGCGTGGCT
GAGATGGTTCACCTTGCGC -> AGATGGTTCACCTTGCGCG
ATCAAAGAGATGGTTCACC -> TCAAAGAGATGGTTCACCT
GGAGGCGTCAGTAATTCAT -> GAGGCGTCAGTAATTCATT
AGCAATCTGGGCAATCGGT -> GCAATCTGGGCAATCGGTT
CTTGGTAGTACGCCTGCAC -> TTGGTAGTACGCCTGCACA
TTGCGCATGCTTGCGCTCA -> TGCGCATGCTTGCGCTCAT
CGATAAATAAGACGCAATG -> GATAAATAAGACGCAATGC
GAGTGAACAAATGGAGTTG -> AGTGAACAAATGGAGTTGT
TCACCAACAAGTACCCCGT -> CACCAACAAGTACCCCGTC
GAATTTCGCCCTTCAGTGG -> AATTTCGCCCTTCAGTGGG,AATTTCGCCCTTCAGTGGC,AATTTCGCCCTTCAGTGGT,AATTTCGCCCTTCAGTGGG
ATGGGTCAAACAAGATTAA -> TGGGTCAAACAAGATTAAG
TGTCAACGTGCCCTCGGGA -> GTCAACGTGCCCTCGGGAA
GTGTCAACGTGCCCTCGGG -> TGTCAACGTGCCCTCGGGA
TCCTGGCACTTAGCGAAAG -> CCTGGCACTTAGCGAAAGA
GGGAGTATGTCCTCTGCAA -> GGAGTATGTCCTCTGCAAT
GCCGTTGTCTCGCCCGCGT -> CCGTTGTCTCGCCCGCGTA
GCCACGTATTCAGTACTCA -> CCACGTATTCAGTACTCAA
AGTGGAATTTCGCCCTTCA -> GTGGAATTTCGCCCTTCAG
CCACAGTCCTGTCTCGTTT -> CACAGTCCTGTCTCGTTTC
AATGGAGTTGTCTTACGCG -> ATGGAGTTGTCTTACGCGG
GGGCGCAAGGAAACCAAAC -> GGCGCAAGGAAACCAAACA
TTTCGCTGCGTGGCTGACG -> TTCGCTGCGTGGCTGACGG
CGACTATGTGTGATTGAAT -> GACTATGTGTGATTGAATA
CTGTGTCAACGTGCCCTCG -> TGTGTCAACGTGCCCTCGG
ACGTCCAACGCGCAGATCA -> CGTCCAACGCGCAGATCAG
TGAAAGACAAGCACACTGT -> GAAAGACAAGCACACTGTC
CCTTCAGTGGGCGCAAGGA -> CTTCAGTGGGCGCAAGGAA
AGTAGATACCGATAGTGTA -> GTAGATACCGATAGTGTAG
TCTGCGACGATGGTTTGGT -> CTGCGACGATGGTTTGGTC
ACGTATTCAGTACTCAATG -> CGTATTCAGTACTCAATGG
AGATGAGCCACGTATTCAG -> GATGAGCCACGTATTCAGT
GCGCTATGGCAAGTAACGG -> CGCTATGGCAAGTAACGGG
AAATGGAGTTGTCTGGGAA -> AATGGAGTTGTCTGGGAAG
GTAGATACCGATAGTGTAG -> TAGATACCGATAGTGTAGC
AGACTTTTTGAACGACATG -> GACTTTTTGAACGACATGC
ACTCAATGGAGGCGTCAGT -> CTCAATGGAGGCGTCAGTA
TATTTGGCACTCACGGACC -> ATTTGGCACTCACGGACCC
ATGGGTAAGCCTGAAGTCT -> TGGGTAAGCCTGAAGTCTC
CTGCTGGGAGTATGTCCTC -> TGCTGGGAGTATGTCCTCT
TTGGTCGGCACTAAGCTGG -> TGGTCGGCACTAAGCTGGT
AACGTGCCCTCGGGAACGG -> ACGTGCCCTCGGGAACGGA
TCCTTTTTTTGTTGTCTCG -> CCTTTTTTTGTTGTCTCGT
CAACTCGCGCTATGGCAAG -> AACTCGCGCTATGGCAAGT
GTCTCAAGCAGAGTGGAAT -> TCTCAAGCAGAGTGGAATT
CAGTTTGGCCCTCCGATTT -> AGTTTGGCCCTCCGATTTC
ATGAGCCACGTATTCAGTA -> TGAGCCACGTATTCAGTAC
CCTGCACAGGGCTTCTCGA -> CTGCACAGGGCTTCTCGAT
TCAACGTGCCCTCGGGAAC -> CAACGTGCCCTCGGGAACG
TCTCAGGGGTCGTTGGTTA -> CTCAGGGGTCGTTGGTTAG
TAGAGCTCTGACCACCGGC -> AGAGCTCTGACCACCGGCC
ATCTCATAACTACGGTCTC -> TCTCATAACTACGGTCTCT
AGTCCGCTTACTCGTCCGA -> GTCCGCTTACTCGTCCGAC
CGCCCTTCAGTGGGGAATT -> GCCCTTCAGTGGGGAATTT
TGGTATTGACTAGACGGGT -> GGTATTGACTAGACGGGTA
CCCTTCAGTGGCATGCAAG -> CCTTCAGTGGCATGCAAGG
TGTCTCAAGCAGAGTGGAA -> GTCTCAAGCAGAGTGGAAT
TTGGCCCTCCGATTTCGGC -> TGGCCCTCCGATTTCGGCT
AAGTACGGGACGCTCCTCA -> AGTACGGGACGCTCCTCAA
AGCAAAGATGAGCCACGTA -> GCAAAGATGAGCCACGTAT
GTTGATAGCGCTTATCGCG -> TTGATAGCGCTTATCGCGG
TTGTATAGTACAGGATTAA -> TGTATAGTACAGGATTAAT
GTGCCGCAAGTAGATACCG -> TGCCGCAAGTAGATACCGA
GTGGCCGAACAGAGCCGAG -> TGGCCGAACAGAGCCGAGT
TACGGGACGCTCCTCAATA -> ACGGGACGCTCCTCAATAA
CGGGACGCTCCTCAATAAA -> GGGACGCTCCTCAATAAAT
ATACGTTGTATAGTACAGG -> TACGTTGTATAGTACAGGA
CATGCGTTCCAAAGACCTG -> ATGCGTTCCAAAGACCTGG
TAGGCGACGAAAGCGTCTG -> AGGCGACGAAAGCGTCTGC
AATGGAGGCGTCAGTAATT -> ATGGAGGCGTCAGTAATTC
CGTTGATAGCGCTTATCGC -> GTTGATAGCGCTTATCGCG
GCAGCCGCCCGAGTCAAGT -> CAGCCGCCCGAGTCAAGTA
AGTTGCGCATGCTTGCGCT -> GTTGCGCATGCTTGCGCTC
ACAACGTCCAACGCGCAGA -> CAACGTCCAACGCGCAGAT
GCTCATGTGCAACTCTATT -> CTCATGTGCAACTCTATTC
CGGGTGTCACTTGGTAGTA -> GGGTGTCACTTGGTAGTAC
AGTTCGCAGACTTTGCATG -> GTTCGCAGACTTTGCATGC
GCGATTTTTAGTCAGTTCG -> CGATTTTTAGTCAGTTCGG
CCGATGGACGCCATCTCAT -> CGATGGACGCCATCTCATA
GAGTTCGCAGACTTTGCAT -> AGTTCGCAGACTTTGCATG
TCAATGCACACGCCGTTGT -> CAATGCACACGCCGTTGTC
TCTCCAAGTCATGGGTAAG -> CTCCAAGTCATGGGTAAGC
GTTGTCTCGCCCGCGTATG -> TTGTCTCGCCCGCGTATGG
CACATGCGTTCCAAAGACC -> ACATGCGTTCCAAAGACCT
ACGCCTAGAGCTCTGACCA -> CGCCTAGAGCTCTGACCAC
CCACAGTCCGACGGACACG -> CACAGTCCGACGGACACGA
CCGATAGTGTAGCGGTCAC -> CGATAGTGTAGCGGTCACC
GCGAAAGAAATCGGCTCCC -> CGAAAGAAATCGGCTCCCG
GTTAGGGAATTTCGCCCTT -> TTAGGGAATTTCGCCCTTC
TACGTCCTCCTCGGTGTAA -> ACGTCCTCCTCGGTGTAAT
GATGGGTCAGGATTGAAAT -> ATGGGTCAGGATTGAAATT
GGCGCAAGGAAACCAAACA -> GCGCAAGGAAACCAAACAG
AATAGAGCTCCATCACCAA -> ATAGAGCTCCATCACCAAC
TGGGCAATCGGTTTCTAGC -> GGGCAATCGGTTTCTAGCC
CTCCACCAGTCCTCATGAA -> TCCACCAGTCCTCATGAAA
CACACTACATGGATGGGTC -> ACACTACATGGATGGGTCA
GCTTGCGTTGTTATAGTCC -> CTTGCGTTGTTATAGTCCT
CCTCATGAAAGACAAGCAC -> CTCATGAAAGACAAGCACA
AATTCATTCCTGTAGCCCT -> ATTCATTCCTGTAGCCCTC
AGAACAAATGGAGTTGTCT -> GAACAAATGGAGTTGTCTA
TACAGGGTCAAGAGACACC -> ACAGGGTCAAGAGACACCG
TCCAAAGACCTGGGATGTA -> CCAAAGACCTGGGATGTAC
CTGACGGTCAACAACTGTG -> TGACGGTCAACAACTGTGC
TGGCAAGTAACGGGGCAGC -> GGCAAGTAACGGGGCAGCA
GAAGCATGCTGCCCTCCAC -> AAGCATGCTGCCCTCCACC
ATTGACTTAACCCGATCAG -> TTGACTTAACCCGATCAGT
AATTAAGTAGATATGGGCA -> ATTAAGTAGATATGGGCAG
ATTTAAGGGTAAATTACTA -> TTTAAGGGTAAATTACTAT
ACGATCTGTGTCAACGTGC -> CGATCTGTGTCAACGTGCC
TGTCTAACGTTGGAGTGAA -> GTCTAACGTTGGAGTGAAC
GCGACGATGGTTTGGTCAC -> CGACGATGGTTTGGTCACA
TTGTCTCGCCCGCGTATGG -> TGTCTCGCCCGCGTATGGG
GGAGCTCAATGACCCGTTT -> GAGCTCAATGACCCGTTTT
GATTTTTAGTCAGTTCGGT -> ATTTTTAGTCAGTTCGGTA
TCCGCAGTGGCCGAACAGA -> CCGCAGTGGCCGAACAGAG
GTACCACACGTTCGCATAT -> TACCACACGTTCGCATATT
GTTAGCACACACGTGGTTA -> TTAGCACACACGTGGTTAC
TTTGTTGTCTCGTCCGTGT -> TTGTTGTCTCGTCCGTGTA
ACACGCCGTTGTCTCGCCC -> CACGCCGTTGTCTCGCCCG
AAATGGAGTTGTCTCAAGC -> AATGGAGTTGTCTCAAGCA
TGTGCAACTCTATTCGCAG -> GTGCAACTCTATTCGCAGA
TTGTCTCAAGCAGAGTGGA -> TGTCTCAAGCAGAGTGGAA
ACATAAAGTCAGTTACCAG -> CATAAAGTCAGTTACCAGA
GTGTACGCACTTTTCGCTG -> TGTACGCACTTTTCGCTGC
CGCCCTTCAGTGGCATGCA -> GCCCTTCAGTGGCATGCAA
GTATGGGGCAGGACAAATG -> TATGGGGCAGGACAAATGC
AGTGGTGCCGCAAGTAGAT -> GTGGTGCCGCAAGTAGATA
ACCTGCGTTGATAGCGCTT -> CCTGCGTTGATAGCGCTTA
AACCACAGTTCAAGAGCTT -> ACCACAGTTCAAGAGCTTG
CAGGATTGAAATTCTGCAC -> AGGATTGAAATTCTGCACG
TGGTAGTACGCCTGCACAG -> GGTAGTACGCCTGCACAGG
AAAGACCTGGGATGTACAA -> AAGACCTGGGATGTACAAT
CAAATGGTGAACAACTACA -> AAATGGTGAACAACTACAA
CACATTGCATCTCCAAGTC -> ACATTGCATCTCCAAGTCA
TGGACGCCATCTCATAACT -> GGACGCCATCTCATAACTA
TGGAGTTGTCTGGGAAGTT -> GGAGTTGTCTGGGAAGTTA
TTACCAGACCAGGGCGGTA -> TACCAGACCAGGGCGGTAC
GGTTTCTAGCCTAGGAAAA -> GTTTCTAGCCTAGGAAAAG
CCACGTATTCAGTACTCAA -> CACGTATTCAGTACTCAAT
GTCACTTGGTAGTACGCCT -> TCACTTGGTAGTACGCCTG
ACGACATGCCTCGAGCAAA -> CGACATGCCTCGAGCAAAG
TCCGATTTCGGCTAGAAAC -> CCGATTTCGGCTAGAAACC
AACAAGTACCCCGTCACCC -> ACAAGTACCCCGTCACCCT
ACGGACACGAACAAATGGA -> CGGACACGAACAAATGGAG
CAGTCCGACGGACACGAAC -> AGTCCGACGGACACGAACA
GACTTTGCATGCATACATT -> ACTTTGCATGCATACATTT
GGAATTTCGCCCTTCAGTG -> GAATTTCGCCCTTCAGTGG,GAATTTCGCCCTTCAGTGG,GAATTTCGCCCTTCAGTGG
CTCAGGGGTCGTTGGTTAG -> TCAGGGGTCGTTGGTTAGG
AATAAACATGCATATGCTA -> ATAAACATGCATATGCTAT
CTAGCCCCCAAGCTTGTAT -> TAGCCCCCAAGCTTGTATG
TGCAATGAGCAAATGGTGA -> GCAATGAGCAAATGGTGAA
CGGGTATACGTGCAGCCGC -> GGGTATACGTGCAGCCGCC
GGTAGTACGCCTGCACAGG -> GTAGTACGCCTGCACAGGG
TTATCGCGGGTGTCACTTG -> TATCGCGGGTGTCACTTGG
ACGTCCTCCTCGGTGTAAT -> CGTCCTCCTCGGTGTAATT
CGCACGACGCGAGAGCGAA -> GCACGACGCGAGAGCGAAT
ACACGAACAAATGGAGTTG -> CACGAACAAATGGAGTTGT
TAACCCGATCAGTTTGGCC -> AACCCGATCAGTTTGGCCC
TAAGGGTAAATTACTATTT -> AAGGGTAAATTACTATTTG
GGAATTAAGTAGATATGGG -> GAATTAAGTAGATATGGGC
CCTAGAGCTCTGACCACCG -> CTAGAGCTCTGACCACCGG
TAATTCATTCCTGTAGCCC -> AATTCATTCCTGTAGCCCT
GTTGGTTAGGCAGAAATGT -> TTGGTTAGGCAGAAATGTC
CAACTCTATTCGCAGATAG -> AACTCTATTCGCAGATAGC
ACGTGCCCTCGGGAACGGA -> CGTGCCCTCGGGAACGGAG
TGAAGTCTCCCTCTGTCGT -> GAAGTCTCCCTCTGTCGTG
TCGGTGTAATTGACTTAAC -> CGGTGTAATTGACTTAACC
TACTATTTGGCACTCACGG -> ACTATTTGGCACTCACGGA
CGCGGGACCGAATTTCGCC -> GCGGGACCGAATTTCGCCC
ATTAAGTAGATATGGGCAG -> TTAAGTAGATATGGGCAGC
TGCGCATGCTTGCGCTCAT -> GCGCATGCTTGCGCTCATG
CCATTTTCGGAGATTCTTG -> CATTTTCGGAGATTCTTGC
AAATCCGACGCCTAGAGCT -> AATCCGACGCCTAGAGCTC
GAGCGAATCAACCACAGTT -> AGCGAATCAACCACAGTTC
GTTACGTCCTCCTCGGTGT -> TTACGTCCTCCTCGGTGTA
CCTCAACAACGTCCAACGC -> CTCAACAACGTCCAACGCG
GCATGCTGCCCTCCACCAG -> CATGCTGCCCTCCACCAGT
TCTTGCGGAATTAAGTAGA -> CTTGCGGAATTAAGTAGAT
AGTTCGGTACCACACGTTC -> GTTCGGTACCACACGTTCG
TCCACATGCGTTCCAAAGA -> CCACATGCGTTCCAAAGAC
ACCAGACCAGGGCGGTACG -> CCAGACCAGGGCGGTACGG
TCGAGTTCGCAGACTTTGC -> CGAGTTCGCAGACTTTGCA
CGAACAAATGGAGTTGTCT -> GAACAAATGGAGTTGTCTC
CAACGTCCAACGCGCAGAT -> AACGTCCAACGCGCAGATC
CTCAAACGTCAAGCAATCT -> TCAAACGTCAAGCAATCTG
CACGAAAGTAGACTTTTTG -> ACGAAAGTAGACTTTTTGA
ATGGGCAGCCACGAAAGTA -> TGGGCAGCCACGAAAGTAG
TCCGTGTAATCCCACAGTC -> CCGTGTAATCCCACAGTCC
GCAAATGGTGAACAACTAC -> CAAATGGTGAACAACTACA
GTAAGCCCACAGTCCTGTC -> TAAGCCCACAGTCCTGTCT
CGGTCAACAACTGTGCTCC -> GGTCAACAACTGTGCTCCT
CCTGAAGTCTCCCTCTGTC -> CTGAAGTCTCCCTCTGTCG
AAGCACACTGTCATTATAT -> AGCACACTGTCATTATATG
GCTCAATGACCCGTTTTTG -> CTCAATGACCCGTTTTTGA
GCTGGTATTGACTAGACGG -> CTGGTATTGACTAGACGGG
GCTATGGCAAGTAACGGGG -> CTATGGCAAGTAACGGGGC
TATGTCCTCTGCAATGAGC -> ATGTCCTCTGCAATGAGCA
ACAGAGCCGAGTTACCAGA -> CAGAGCCGAGTTACCAGAA
TAGATACCGATAGTGTAGC -> AGATACCGATAGTGTAGCG
AATGGTGAACAACTACAAC -> ATGGTGAACAACTACAACA
GACATGCCTCGAGCAAAGA -> ACATGCCTCGAGCAAAGAT
AATCGACGCTGGAACAAAT -> ATCGACGCTGGAACAAATG
CGGCACACTACATGGATGG -> GGCACACTACATGGATGGG
GGGCAGCCACGAAAGTAGA -> GGCAGCCACGAAAGTAGAC
TTGGTAGTACGCCTGCACA -> TGGTAGTACGCCTGCACAG
CTACAGGGTCAAGAGACAC -> TACAGGGTCAAGAGACACC
ATCGCGGGTGTCACTTGGT -> TCGCGGGTGTCACTTGGTA
GAGTATGTCCTCTGCAATG -> AGTATGTCCTCTGCAATGA
TCAGCCACAACTCGCGCTA -> CAGCCACAACTCGCGCTAT
CATGCTTGCGCTCATGTGC -> ATGCTTGCGCTCATGTGCA
GGGTGTCACTTGGTAGTAC -> GGTGTCACTTGGTAGTACG
CGGACACGAACAAATGGAG -> GGACACGAACAAATGGAGT
ACAAGATTAAGAGCACTCA -> CAAGATTAAGAGCACTCAA
CCACACGTTCGCATATTCA -> CACACGTTCGCATATTCAA
TCAACAACTGTGCTCCTTT -> CAACAACTGTGCTCCTTTT
CATTTTCGGAGATTCTTGC -> ATTTTCGGAGATTCTTGCG
GCAATCTGGGCAATCGGTT -> CAATCTGGGCAATCGGTTT
CACGTTCGCATATTCAAGT -> ACGTTCGCATATTCAAGTA
CTGCCGGAGAGACATGATC -> TGCCGGAGAGACATGATCG
CATCTCATAACTACGGTCT -> ATCTCATAACTACGGTCTC
ACACGTGGTTACGTCCTCC -> CACGTGGTTACGTCCTCCT
AGACCTGGGATGTACAATA -> GACCTGGGATGTACAATAG
CGTGCAGCCGCCCGAGTCA -> GTGCAGCCGCCCGAGTCAA
TCCATCACCAACAAGTACC -> CCATCACCAACAAGTACCC
AGATGGTTCACCTTGCGCG -> GATGGTTCACCTTGCGCGC
TTGCATGCATACATTTAAG -> TGCATGCATACATTTAAGG
GTAGTACGCCTGCACAGGG -> TAGTACGCCTGCACAGGGC
CAAGCTTGTATGTGGTAAC -> AAGCTTGTATGTGGTAACC
TACAACAGTTCATCAATGC -> ACAACAGTTCATCAATGCA
AGATTAAGAGCACTCAAAC -> GATTAAGAGCACTCAAACG
TCACAAGTTAGCACACACG -> CACAAGTTAGCACACACGT
TCCTCATGAAAGACAAGCA -> CCTCATGAAAGACAAGCAC
ACCACACGTTCGCATATTC -> CCACACGTTCGCATATTCA
TGGGGAATTTCGCCCTTCA -> GGGGAATTTCGCCCTTCAG
CAAGCACACTGTCATTATA -> AAGCACACTGTCATTATAT
GCGACTATGTGTGATTGAA -> CGACTATGTGTGATTGAAT
ATGGAGTTGTCTCAAGCAG -> TGGAGTTGTCTCAAGCAGA
CTACAACAGTTCATCAATG -> TACAACAGTTCATCAATGC
GGATGACTTGTCGGGTATA -> GATGACTTGTCGGGTATAC
TCGCGGCACACTACATGGA -> CGCGGCACACTACATGGAT
GGACGCCATCTCATAACTA -> GACGCCATCTCATAACTAC
GGATGTACAATAGGTTAGT -> GATGTACAATAGGTTAGTT
TAAATGTTTGGTCGGCACT -> AAATGTTTGGTCGGCACTA
TTGCGTTGTTATAGTCCTG -> TGCGTTGTTATAGTCCTGG
CACACTGTCATTATATGCC -> ACACTGTCATTATATGCCC
CAGGAGCAACCCTAGCGTC -> AGGAGCAACCCTAGCGTCC
CATGCATACATTTAAGGGT -> ATGCATACATTTAAGGGTA
GACCAGGGCGGTACGGGTG -> ACCAGGGCGGTACGGGTGT
ATACATTTAAGGGTAAATT -> TACATTTAAGGGTAAATTA
TTGAGGGCATAGCTCAGTC -> TGAGGGCATAGCTCAGTCA
CCGGAGAGACATGATCGCC -> CGGAGAGACATGATCGCCG
GATTAATGGCGCTCTCAGG -> ATTAATGGCGCTCTCAGGG
ACACTACATGGATGGGTCA -> CACTACATGGATGGGTCAG
AAGACGCAATGCTAAATAA -> AGACGCAATGCTAAATAAA
ACCAAACAGCCCGAGCGGT -> CCAAACAGCCCGAGCGGTT
CGTGTAATCCCACAGTCCG -> GTGTAATCCCACAGTCCGA
CCCCCGCACGACGCGAGAG -> CCCCGCACGACGCGAGAGC
GTTGTCTGGGAAGTTAGGG -> TTGTCTGGGAAGTTAGGGA
CAAGCAATCTGGGCAATCG -> AAGCAATCTGGGCAATCGG
TATTCAGTACTCAATGGAG -> ATTCAGTACTCAATGGAGG
GGGTATACGTGCAGCCGCC -> GGTATACGTGCAGCCGCCC
TATGGCAAGTAACGGGGCA -> ATGGCAAGTAACGGGGCAG
AGGTTAGTTGCAGGAGCAA -> GGTTAGTTGCAGGAGCAAC
AGCCATTTTCGGAGATTCT -> GCCATTTTCGGAGATTCTT
AGTCCTGTCTCGTTTCTGT -> GTCCTGTCTCGTTTCTGTA
GCATAGCTCAGTCATAGTT -> CATAGCTCAGTCATAGTTC
GTAATTGACTTAACCCGAT -> TAATTGACTTAACCCGATC
ATCTACAGGGTCAAGAGAC -> TCTACAGGGTCAAGAGACA
TCACTTGGTAGTACGCCTG -> CACTTGGTAGTACGCCTGC
GTACCCCGTCACCCTTCCT -> TACCCCGTCACCCTTCCTG
TACATTTAAGGGTAAATTA -> ACATTTAAGGGTAAATTAC
GCCCGAGCGGTTGCGATCA -> CCCGAGCGGTTGCGATCAA
CCTGCGTTGATAGCGCTTA -> CTGCGTTGATAGCGCTTAT
CTTCTGCGACGATGGTTTG -> TTCTGCGACGATGGTTTGG
GATAGCGCTTATCGCGGGT -> ATAGCGCTTATCGCGGGTG
TGGGGCAGGACAAATGCTT -> GGGGCAGGACAAATGCTTA
TATGTGGTAACCACCATTA -> ATGTGGTAACCACCATTAA
GACGCTGGAACAAATGGAG -> ACGCTGGAACAAATGGAGT
ATGTGTGATTGAATATAGA -> TGTGTGATTGAATATAGAG
GTCCGCTTACTCGTCCGAC -> TCCGCTTACTCGTCCGACG
CCCACCCCTGCTGGGAGTA -> CCACCCCTGCTGGGAGTAT
ACCCTAGCCCCCAAGCTTG -> CCCTAGCCCCCAAGCTTGT
GTTTCTAGCCTAGGAAAAG -> TTTCTAGCCTAGGAAAAGG
CGTTGTTATAGTCCTGGCA -> GTTGTTATAGTCCTGGCAC
CACAGTTCAAGAGCTTGCG -> ACAGTTCAAGAGCTTGCGT
CTGTGCTCCTTTTTTTGTT -> TGTGCTCCTTTTTTTGTTG
AGTCAGTTCGGTACCACAC -> GTCAGTTCGGTACCACACG
CACTTTTCGCTGCGTGGCT -> ACTTTTCGCTGCGTGGCTG
CTCGAGCAAAGATGAGCCA -> TCGAGCAAAGATGAGCCAC
ATGGGGCAGGACAAATGCT -> TGGGGCAGGACAAATGCTT
ATGGCAAGTAACGGGGCAG -> TGGCAAGTAACGGGGCAGC
CACTGTCATTATATGCCCT -> ACTGTCATTATATGCCCTG
AACAGAGCCGAGTTACCAG -> ACAGAGCCGAGTTACCAGA
CTCAGTCATAGTTCATTAA -> TCAGTCATAGTTCATTAAG
CGGGAACGGAGGAGCTCAA -> GGGAACGGAGGAGCTCAAT
GTGCAACTCTATTCGCAGA -> TGCAACTCTATTCGCAGAT
GAGGAGCTCAATGACCCGT -> AGGAGCTCAATGACCCGTT
TTTGAGGGCATAGCTCAGT -> TTGAGGGCATAGCTCAGTC
ATATAGAGATGGGTCAAAC -> TATAGAGATGGGTCAAACA
CCCAAGCTTGTATGTGGTA -> CCAAGCTTGTATGTGGTAA
ATGATCGCCGCGACGCGGA -> TGATCGCCGCGACGCGGAG
GTGGCTGACGGTCAACAAC -> TGGCTGACGGTCAACAACT
CAATCGGTTTCTAGCCTAG -> AATCGGTTTCTAGCCTAGG
TCTCGATCTACAGGGTCAA -> CTCGATCTACAGGGTCAAG
TGGTTGAGTGGCCCCTCCC -> GGTTGAGTGGCCCCTCCCA
TATACGTGCAGCCGCCCGA -> ATACGTGCAGCCGCCCGAG
GCCCTTCAGTGGGGAATTT -> CCCTTCAGTGGGGAATTTC
CAGTGGCATGCAAGGCTTG -> AGTGGCATGCAAGGCTTGA
TGGCGACTATGTGTGATTG -> GGCGACTATGTGTGATTGA
TGTAGCGGTCACCCAATAT -> GTAGCGGTCACCCAATATT
GCTCCTTTTTTTGTTGTCT -> CTCCTTTTTTTGTTGTCTC
GCTTCTCGATCTACAGGGT -> CTTCTCGATCTACAGGGTC
CGTCACCCTTCCTGGATGA -> GTCACCCTTCCTGGATGAC
ATCAGCCACAACTCGCGCT -> TCAGCCACAACTCGCGCTA
GATTAAAGCTGTGGTTGAG -> ATTAAAGCTGTGGTTGAGT
GTTTTTGAGGGCATAGCTC -> TTTTTGAGGGCATAGCTCA
GATTGAAATTCTGCACGAT -> ATTGAAATTCTGCACGATC
ACGTTCGCATATTCAAGTA -> CGTTCGCATATTCAAGTAC
ATCGGTTTCTAGCCTAGGA -> TCGGTTTCTAGCCTAGGAA
CAGAAATGTCGACGACCCT -> AGAAATGTCGACGACCCTT
CCTCCCACCCCTGCTGGGA -> CTCCCACCCCTGCTGGGAG
GATCTACAGGGTCAAGAGA -> ATCTACAGGGTCAAGAGAC
CCCCTCCCACCCCTGCTGG -> CCCTCCCACCCCTGCTGGG
GGGAACGGAGGAGCTCAAT -> GGAACGGAGGAGCTCAATG
GAGTGGAATTTCGCCCTTC -> AGTGGAATTTCGCCCTTCA
CACAACTCGCGCTATGGCA -> ACAACTCGCGCTATGGCAA
ATGGAGTTGTCTAACGTTG -> TGGAGTTGTCTAACGTTGG
CGGAGGAGCTCAATGACCC -> GGAGGAGCTCAATGACCCG
GGTGTCACTTGGTAGTACG -> GTGTCACTTGGTAGTACGC
ACAAATGGAGTTGTCTAAC -> CAAATGGAGTTGTCTAACG
CATACATTTAAGGGTAAAT -> ATACATTTAAGGGTAAATT
GTCGACGACCCTTGCCGAT -> TCGACGACCCTTGCCGATA
GGCAGGACAAATGCTTAGA -> GCAGGACAAATGCTTAGAA
CCACGAAAGTAGACTTTTT -> CACGAAAGTAGACTTTTTG
CAAAGATGAGCCACGTATT -> AAAGATGAGCCACGTATTC
ATGTTTGGTCGGCACTAAG -> TGTTTGGTCGGCACTAAGC
GGTATACGTGCAGCCGCCC -> GTATACGTGCAGCCGCCCG
ATGGCGCTCTCAGGGGTCG -> TGGCGCTCTCAGGGGTCGT
AACTCTATTCGCAGATAGC -> ACTCTATTCGCAGATAGCC
ATTCAGTACTCAATGGAGG -> TTCAGTACTCAATGGAGGC
CCTCTGCAATGAGCAAATG -> CTCTGCAATGAGCAAATGG
AATGGCGCTCTCAGGGGTC -> ATGGCGCTCTCAGGGGTCG
GGGGAATTTCGCCCTTCAG -> GGGAATTTCGCCCTTCAGT
CACCCCTGCTGGGAGTATG -> ACCCCTGCTGGGAGTATGT
TATTCCGCAGTGGCCGAAC -> ATTCCGCAGTGGCCGAACA
GGATGGGTCAGGATTGAAA -> GATGGGTCAGGATTGAAAT
CTTTTTTTGTTGTCTCGTC -> TTTTTTTGTTGTCTCGTCC
AAGTCAGTTACCAGACCAG -> AGTCAGTTACCAGACCAGG
GTAAAGTCGAGTTCGCAGA -> TAAAGTCGAGTTCGCAGAC
GAGACACCGCGGCGCATAC -> AGACACCGCGGCGCATACA
CAACAACGTCCAACGCGCA -> AACAACGTCCAACGCGCAG
TGGTCGGCACTAAGCTGGT -> GGTCGGCACTAAGCTGGTA
AAGTCGAGTTCGCAGACTT -> AGTCGAGTTCGCAGACTTT
GTCCTCATGAAAGACAAGC -> TCCTCATGAAAGACAAGCA
TTCTTGCGGAATTAAGTAG -> TCTTGCGGAATTAAGTAGA
CGCGAGAGCGAATCAACCA -> GCGAGAGCGAATCAACCAC
AAGCAGAGTGGAATTTCGC -> AGCAGAGTGGAATTTCGCC
GCTGTGGTTGAGTGGCCCC -> CTGTGGTTGAGTGGCCCCT
AGGGCTTCTCGATCTACAG -> GGGCTTCTCGATCTACAGG
CCACAACTCGCGCTATGGC -> CACAACTCGCGCTATGGCA
GCCGCGACGCGGAGGCAGA -> CCGCGACGCGGAGGCAGAA
GAGCGGTTGCGATCAAAGA -> AGCGGTTGCGATCAAAGAG
CGAGAGCGAATCAACCACA -> GAGAGCGAATCAACCACAG
ACCACAGTTCAAGAGCTTG -> CCACAGTTCAAGAGCTTGC
CGTTGGAGTGAACAAATGG -> GTTGGAGTGAACAAATGGA
AAAGCTGTGGTTGAGTGGC -> AAGCTGTGGTTGAGTGGCC
GTCATTATATGCCCTGCCG -> TCATTATATGCCCTGCCGG
CGGTGTAATTGACTTAACC -> GGTGTAATTGACTTAACCC
ATTAAGTAAATTCCAGCCA -> TTAAGTAAATTCCAGCCAT
TAAAGTCCGCTTACTCGTC -> AAAGTCCGCTTACTCGTCC
TTCCAAAGACCTGGGATGT -> TCCAAAGACCTGGGATGTA
CTCCACATGCGTTCCAAAG -> TCCACATGCGTTCCAAAGA
AGTGTAGCGGTCACCCAAT -> GTGTAGCGGTCACCCAATA
ATTCAAGTACGGGACGCTC -> TTCAAGTACGGGACGCTCC
GATGGTTTGGTCACAAGTT -> ATGGTTTGGTCACAAGTTA
CTGTCATTATATGCCCTGC -> TGTCATTATATGCCCTGCC
CTCTTGGCGACTATGTGTG -> TCTTGGCGACTATGTGTGA
GAGCTCCATCACCAACAAG -> AGCTCCATCACCAACAAGT
CGGACCCCCGCACGACGCG -> GGACCCCCGCACGACGCGA
ATGCACACGCCGTTGTCTC -> TGCACACGCCGTTGTCTCG
ACGCACTTTTCGCTGCGTG -> CGCACTTTTCGCTGCGTGG
AGTATGTCCTCTGCAATGA -> GTATGTCCTCTGCAATGAG
AATCGGCTCCCGCCCTACG -> ATCGGCTCCCGCCCTACGA
CCACAGTTCAAGAGCTTGC -> CACAGTTCAAGAGCTTGCG
TCGGGTATACGTGCAGCCG -> CGGGTATACGTGCAGCCGC
GCACACTACATGGATGGGT -> CACACTACATGGATGGGTC
TATCGCGGGTGTCACTTGG -> ATCGCGGGTGTCACTTGGT
ACGGGTGTACGCACTTTTC -> CGGGTGTACGCACTTTTCG
TACCAGAATCGACGCTGGA -> ACCAGAATCGACGCTGGAA
GAGTTACCAGAATCGACGC -> AGTTACCAGAATCGACGCT
TGCTGGGAGTATGTCCTCT -> GCTGGGAGTATGTCCTCTG
AATCAACCACAGTTCAAGA -> ATCAACCACAGTTCAAGAG
CGTGGCTGACGGTCAACAA -> GTGGCTGACGGTCAACAAC
GAACAAATGGAGTTGTCTC -> AACAAATGGAGTTGTCTCA
AGTACGGGACGCTCCTCAA -> GTACGGGACGCTCCTCAAT
GGCCCCTCCCACCCCTGCT -> GCCCCTCCCACCCCTGCTG
AACGCGCAGATCAGCCACA -> ACGCGCAGATCAGCCACAA
AATTTCGCCCTTCAGTGGT -> ATTTCGCCCTTCAGTGGTG
CTTGCGTTGTTATAGTCCT -> TTGCGTTGTTATAGTCCTG
TCATCAATGCACACGCCGT -> CATCAATGCACACGCCGTT
ACGCCTGCACAGGGCTTCT -> CGCCTGCACAGGGCTTCTC
TAAGACGCAATGCTAAATA -> AAGACGCAATGCTAAATAA
GCCGAGTTACCAGAATCGA -> CCGAGTTACCAGAATCGAC
TAGAGCTCCATCACCAACA -> AGAGCTCCATCACCAACAA
TTGCAGGAGCAACCCTAGC -> TGCAGGAGCAACCCTAGCG
AAACGTCAAGCAATCTGGG -> AACGTCAAGCAATCTGGGC
TGGGCAGCCACGAAAGTAG -> GGGCAGCCACGAAAGTAGA
TGAAATTCTGCACGATCGA -> GAAATTCTGCACGATCGAC
GCCCCTCCCACCCCTGCTG -> CCCCTCCCACCCCTGCTGG
TTAAAGCTGTGGTTGAGTG -> TAAAGCTGTGGTTGAGTGG
TGACCCGTTTTTGAGGGCA -> GACCCGTTTTTGAGGGCAT
CCATCACCAACAAGTACCC -> CATCACCAACAAGTACCCC
TCAAGAGACACCGCGGCGC -> CAAGAGACACCGCGGCGCA
TTAGAACAAATGGAGTTGT -> TAGAACAAATGGAGTTGTC
CCTTCAGTGGGGAATTTCG -> CTTCAGTGGGGAATTTCGC
AACAAATGGAGTTGTCTGG -> ACAAATGGAGTTGTCTGGG
CTCCGATTTCGGCTAGAAA -> TCCGATTTCGGCTAGAAAC
AACAACTACAACAGTTCAT -> ACAACTACAACAGTTCATC
CCAGACCAGGGCGGTACGG -> CAGACCAGGGCGGTACGGG
ATACCGATAGTGTAGCGGT -> TACCGATAGTGTAGCGGTC
AGGAGCTCAATGACCCGTT -> GGAGCTCAATGACCCGTTT
CATTCCTGTAGCCCTCAAC -> ATTCCTGTAGCCCTCAACA
CTCACGGACCCCCGCACGA -> TCACGGACCCCCGCACGAC
GATTGAATATAGAGATGGG -> ATTGAATATAGAGATGGGT
GAAACCACATTGCATCTCC -> AAACCACATTGCATCTCCA
AGCACCTGCGTTGATAGCG -> GCACCTGCGTTGATAGCGC
ACCACATTGCATCTCCAAG -> CCACATTGCATCTCCAAGT
TATGGGCAGCCACGAAAGT -> ATGGGCAGCCACGAAAGTA
TACATGGATGGGTCAGGAT -> ACATGGATGGGTCAGGATT
CGTTGTATAGTACAGGATT -> GTTGTATAGTACAGGATTA
CGAAAGCGTCTGCGATTAA -> GAAAGCGTCTGCGATTAAA
TCTATTCGCAGATAGCCAA -> CTATTCGCAGATAGCCAAA
GGTTCACCTTGCGCGCGTA -> GTTCACCTTGCGCGCGTAG
AATATAGAGATGGGTCAAA -> ATATAGAGATGGGTCAAAC
ATTTCGGCTAGAAACCACA -> TTTCGGCTAGAAACCACAT
AACAACTGTGCTCCTTTTT -> ACAACTGTGCTCCTTTTTT
CCAAACAGCCCGAGCGGTT -> CAAACAGCCCGAGCGGTTG
TATAGTCCTGGCACTTAGC -> ATAGTCCTGGCACTTAGCG
ACGCGAGAGCGAATCAACC -> CGCGAGAGCGAATCAACCA
CAAGGAAACCAAACAGCCC -> AAGGAAACCAAACAGCCCG
CAGTCATAGTTCATTAAGT -> AGTCATAGTTCATTAAGTA
AGATACCGATAGTGTAGCG -> GATACCGATAGTGTAGCGG
GGCACTTAGCGAAAGAAAT -> GCACTTAGCGAAAGAAATC
GTAGCGGTCACCCAATATT -> TAGCGGTCACCCAATATTG
CCCTTGCCGATACAGCTCC -> CCTTGCCGATACAGCTCCA
CACTAAGCTGGTATTGACT -> ACTAAGCTGGTATTGACTA
ACCATTAAAGTCCGCTTAC -> CCATTAAAGTCCGCTTACT
CGACATTCTACATAAAGTC -> GACATTCTACATAAAGTCA
GTCTCGCCCGCGTATGGGG -> TCTCGCCCGCGTATGGGGC
CCGAATTTCGCCCTTCAGT -> CGAATTTCGCCCTTCAGTG
TGCCGGAGAGACATGATCG -> GCCGGAGAGACATGATCGC
CCTTAGAATAGAGCTCCAT -> CTTAGAATAGAGCTCCATC
GTTAGTTGCAGGAGCAACC -> TTAGTTGCAGGAGCAACCC
TGTCGTGAACTCATTCGCG -> GTCGTGAACTCATTCGCGG
GCTTATCGCGGGTGTCACT -> CTTATCGCGGGTGTCACTT
ATTTTTAGTCAGTTCGGTA -> TTTTTAGTCAGTTCGGTAC
TCATTCGCGGCACACTACA -> CATTCGCGGCACACTACAT
CGCGCTATGGCAAGTAACG -> GCGCTATGGCAAGTAACGG
TTTGGCCCTCCGATTTCGG -> TTGGCCCTCCGATTTCGGC
GCGCAAGGAAACCAAACAG -> CGCAAGGAAACCAAACAGC
TGGGAGTATGTCCTCTGCA -> GGGAGTATGTCCTCTGCAA
ATGCTTAGAACAAATGGAG -> TGCTTAGAACAAATGGAGT
CGATCGACATTCTACATAA -> GATCGACATTCTACATAAA
GGCTTCTGCGACGATGGTT -> GCTTCTGCGACGATGGTTT
AAGGGTAAATTACTATTTG -> AGGGTAAATTACTATTTGG
ATTGCATCTCCAAGTCATG -> TTGCATCTCCAAGTCATGG
CGTGCCCTCGGGAACGGAG -> GTGCCCTCGGGAACGGAGG
CTTCAGTGGCATGCAAGGC -> TTCAGTGGCATGCAAGGCT
GATCTGTGTCAACGTGCCC -> ATCTGTGTCAACGTGCCCT
TGGAGTTGTCTAACGTTGG -> GGAGTTGTCTAACGTTGGA
ATGGACGCCATCTCATAAC -> TGGACGCCATCTCATAACT
CGAATTTCGCCCTTCAGTG -> GAATTTCGCCCTTCAGTGG
GAGCCACGTATTCAGTACT -> AGCCACGTATTCAGTACTC
AAGTCATGGGTAAGCCTGA -> AGTCATGGGTAAGCCTGAA
GAAATTCTGCACGATCGAC -> AAATTCTGCACGATCGACA
AAAGTCAGTTACCAGACCA -> AAGTCAGTTACCAGACCAG
GCCTTAGAATAGAGCTCCA -> CCTTAGAATAGAGCTCCAT
CGGCGCATACAGTGGTAAG -> GGCGCATACAGTGGTAAGC
CGTTCGCATATTCAAGTAC -> GTTCGCATATTCAAGTACG
AAAGTCGAGTTCGCAGACT -> AAGTCGAGTTCGCAGACTT
CCGACGGCTTCTGCGACGA -> CGACGGCTTCTGCGACGAT
CCCGATCAGTTTGGCCCTC -> CCGATCAGTTTGGCCCTCC
CCGATAAATAAGACGCAAT -> CGATAAATAAGACGCAATG
GGTCAACAACTGTGCTCCT -> GTCAACAACTGTGCTCCTT
TTCGCGGCACACTACATGG -> TCGCGGCACACTACATGGA
GTTCCAAAGACCTGGGATG -> TTCCAAAGACCTGGGATGT
AGACACCGCGGCGCATACA -> GACACCGCGGCGCATACAG
GTCAACAACTGTGCTCCTT -> TCAACAACTGTGCTCCTTT
CCTGCCGGAGAGACATGAT -> CTGCCGGAGAGACATGATC
AGCCTAGGAAAAGGTTATA -> GCCTAGGAAAAGGTTATAC
GCTTGCGCTCATGTGCAAC -> CTTGCGCTCATGTGCAACT
ATCAATGCACACGCCGTTG -> TCAATGCACACGCCGTTGT
TTAGTTGCAGGAGCAACCC -> TAGTTGCAGGAGCAACCCT
ATGAGCAAATGGTGAACAA -> TGAGCAAATGGTGAACAAC
CAACGCGCAGATCAGCCAC -> AACGCGCAGATCAGCCACA
TTGTTGTCTCGTCCGTGTA -> TGTTGTCTCGTCCGTGTAA
TGGGTCAAACAAGATTAAG -> GGGTCAAACAAGATTAAGA
GACGCCTAGAGCTCTGACC -> ACGCCTAGAGCTCTGACCA
GCTCCATCACCAACAAGTA -> CTCCATCACCAACAAGTAC
CGCGGCACACTACATGGAT -> GCGGCACACTACATGGATG
GTTCACCTTGCGCGCGTAG -> TTCACCTTGCGCGCGTAGT
ACTAAGCTGGTATTGACTA -> CTAAGCTGGTATTGACTAG
GTTTGGTCACAAGTTAGCA -> TTTGGTCACAAGTTAGCAC
GAGAGACATGATCGCCGCG -> AGAGACATGATCGCCGCGA
GTCAGTTACCAGACCAGGG -> TCAGTTACCAGACCAGGGC
CAAGTTAGCACACACGTGG -> AAGTTAGCACACACGTGGT
GTCTAACGTTGGAGTGAAC -> TCTAACGTTGGAGTGAACA
CACGACGCGAGAGCGAATC -> ACGACGCGAGAGCGAATCA
AGAATCGACGCTGGAACAA -> GAATCGACGCTGGAACAAA
TCAATAAATGTTTGGTCGG -> CAATAAATGTTTGGTCGGC
CGATCAAAGAGATGGTTCA -> GATCAAAGAGATGGTTCAC
GTTGTATAGTACAGGATTA -> TTGTATAGTACAGGATTAA
TCAGGGGTCGTTGGTTAGG -> CAGGGGTCGTTGGTTAGGC
TGTCATTATATGCCCTGCC -> GTCATTATATGCCCTGCCG
ATAAACATGCATATGCTAT -> TAAACATGCATATGCTATT
ACTACGGTCTCTTGGCGAC -> CTACGGTCTCTTGGCGACT
GCGTTCCAAAGACCTGGGA -> CGTTCCAAAGACCTGGGAT
TACATAAAGTCAGTTACCA -> ACATAAAGTCAGTTACCAG
TAGCGAAAGAAATCGGCTC -> AGCGAAAGAAATCGGCTCC
TCGCCCTTCAGTGGGCGCA -> CGCCCTTCAGTGGGCGCAA
TCAGTCATAGTTCATTAAG -> CAGTCATAGTTCATTAAGT
TATGAGCACCCTAGCCCCC -> ATGAGCACCCTAGCCCCCA
AGTTCAAGAGCTTGCGTTG -> GTTCAAGAGCTTGCGTTGT
GGACGCTCCTCAATAAATG -> GACGCTCCTCAATAAATGT
GTCGTGAACTCATTCGCGG -> TCGTGAACTCATTCGCGGC
ACTCATTCGCGGCACACTA -> CTCATTCGCGGCACACTAC
ACTTAACCCGATCAGTTTG -> CTTAACCCGATCAGTTTGG
CACGATCGACATTCTACAT -> ACGATCGACATTCTACATA
CGAAAGTAGACTTTTTGAA -> GAAAGTAGACTTTTTGAAC
CCCACAGTCCGACGGACAC -> CCACAGTCCGACGGACACG
CGGAGATTCTTGCGGAATT -> GGAGATTCTTGCGGAATTA
TGTCGGGTATACGTGCAGC -> GTCGGGTATACGTGCAGCC
GATCAGCCACAACTCGCGC -> ATCAGCCACAACTCGCGCT
AATAAATGTTTGGTCGGCA -> ATAAATGTTTGGTCGGCAC
TGTCTCGCCCGCGTATGGG -> GTCTCGCCCGCGTATGGGG
TGGAGGCGTCAGTAATTCA -> GGAGGCGTCAGTAATTCAT
GTAATTCATTCCTGTAGCC -> TAATTCATTCCTGTAGCCC
ATGCGTTCCAAAGACCTGG -> TGCGTTCCAAAGACCTGGG
CATTATATGCCCTGCCGGA -> ATTATATGCCCTGCCGGAG
ACAAATGCTTAGAACAAAT -> CAAATGCTTAGAACAAATG
ACGACGCGAGAGCGAATCA -> CGACGCGAGAGCGAATCAA
GATGGTTCACCTTGCGCGC -> ATGGTTCACCTTGCGCGCG
AGCGGTCACCCAATATTGC -> GCGGTCACCCAATATTGCG
AAATGTTTGGTCGGCACTA -> AATGTTTGGTCGGCACTAA
ACCCTAGCGTCCGATAAAT -> CCCTAGCGTCCGATAAATA
CAATATTGCGATTTTTAGT -> AATATTGCGATTTTTAGTC
TGTGGTAACCACCATTAAA -> GTGGTAACCACCATTAAAG
GACTAGACGGGTAAAGTCG -> ACTAGACGGGTAAAGTCGA
TATAGTACAGGATTAATGG -> ATAGTACAGGATTAATGGC
GTCGAGTTCGCAGACTTTG -> TCGAGTTCGCAGACTTTGC
AGGGATACCGATGGACGCC -> GGGATACCGATGGACGCCA
GCAGAAGTTGCGCATGCTT -> CAGAAGTTGCGCATGCTTG
TCGGTACCACACGTTCGCA -> CGGTACCACACGTTCGCAT
ACGTTGTATAGTACAGGAT -> CGTTGTATAGTACAGGATT
AAGTTGCGCATGCTTGCGC -> AGTTGCGCATGCTTGCGCT
ATCGGCTCCCGCCCTACGA -> TCGGCTCCCGCCCTACGAT
TCGGTTTCTAGCCTAGGAA -> CGGTTTCTAGCCTAGGAAA
TTTTTGAGGGCATAGCTCA -> TTTTGAGGGCATAGCTCAG
CCTTCCTGGATGACTTGTC -> CTTCCTGGATGACTTGTCG
GTACAATAGGTTAGTTGCA -> TACAATAGGTTAGTTGCAG
TTTTGAGGGCATAGCTCAG -> TTTGAGGGCATAGCTCAGT
GCCTAGGAAAAGGTTATAC -> CCTAGGAAAAGGTTATACG
ACCGATGGACGCCATCTCA -> CCGATGGACGCCATCTCAT
TAAAGTCGAGTTCGCAGAC -> AAAGTCGAGTTCGCAGACT
ACAGTTCAAGAGCTTGCGT -> CAGTTCAAGAGCTTGCGTT
CTCTCAGGGGTCGTTGGTT -> TCTCAGGGGTCGTTGGTTA
CCGAACAGAGCCGAGTTAC -> CGAACAGAGCCGAGTTACC
TCCGACGGACACGAACAAA -> CCGACGGACACGAACAAAT
CAAAGAGATGGTTCACCTT -> AAAGAGATGGTTCACCTTG
CTCCCACCCCTGCTGGGAG -> TCCCACCCCTGCTGGGAGT
CGACGCTGGAACAAATGGA -> GACGCTGGAACAAATGGAG
CTTATCGCGGGTGTCACTT -> TTATCGCGGGTGTCACTTG
GGAAACCAAACAGCCCGAG -> GAAACCAAACAGCCCGAGC
GCAAGGAAACCAAACAGCC -> CAAGGAAACCAAACAGCCC
TCAATGGAGGCGTCAGTAA -> CAATGGAGGCGTCAGTAAT
GAGTTGTCTAACGTTGGAG -> AGTTGTCTAACGTTGGAGT
AAAGAAATCGGCTCCCGCC -> AAGAAATCGGCTCCCGCCC
AGCCCCCAAGCTTGTATGT -> GCCCCCAAGCTTGTATGTG
GAGCTCTGACCACCGGCCT -> AGCTCTGACCACCGGCCTT
TGTCACTTGGTAGTACGCC -> GTCACTTGGTAGTACGCCT
GCATATTCAAGTACGGGAC -> CATATTCAAGTACGGGACG
CAATCTGGGCAATCGGTTT -> AATCTGGGCAATCGGTTTC
TGGCCCCTCCCACCCCTGC -> GGCCCCTCCCACCCCTGCT
CGCACTTTTCGCTGCGTGG -> GCACTTTTCGCTGCGTGGC
CTTACTCGTCCGACGGCTT -> TTACTCGTCCGACGGCTTC
CCAACGCGCAGATCAGCCA -> CAACGCGCAGATCAGCCAC
ACGGGACGCTCCTCAATAA -> CGGGACGCTCCTCAATAAA
ACTACATGGATGGGTCAGG -> CTACATGGATGGGTCAGGA
GGCTCCCGCCCTACGATCT -> GCTCCCGCCCTACGATCTG
CATACAGTGGTAAGCCCAC -> ATACAGTGGTAAGCCCACA
GGGTCAAGAGACACCGCGG -> GGTCAAGAGACACCGCGGC
TCAAGCAATCTGGGCAATC -> CAAGCAATCTGGGCAATCG
GCACACGCCGTTGTCTCGC -> CACACGCCGTTGTCTCGCC
ATTGAAATTCTGCACGATC -> TTGAAATTCTGCACGATCG
TCATGGGTAAGCCTGAAGT -> CATGGGTAAGCCTGAAGTC
ACGCCGTTGTCTCGCCCGC -> CGCCGTTGTCTCGCCCGCG
TCCGACGCCTAGAGCTCTG -> CCGACGCCTAGAGCTCTGA
AGTCATGGGTAAGCCTGAA -> GTCATGGGTAAGCCTGAAG
CAACAACTGTGCTCCTTTT -> AACAACTGTGCTCCTTTTT
TAAGCCTGAAGTCTCCCTC -> AAGCCTGAAGTCTCCCTCT
CACCCTAGCCCCCAAGCTT -> ACCCTAGCCCCCAAGCTTG
TCGGAGATTCTTGCGGAAT -> CGGAGATTCTTGCGGAATT
AGGGCGGTACGGGTGTACG -> GGGCGGTACGGGTGTACGC
GAGCTCAATGACCCGTTTT -> AGCTCAATGACCCGTTTTT
TTTAGTCAGTTCGGTACCA -> TTAGTCAGTTCGGTACCAC
ATATGGGCAGCCACGAAAG -> TATGGGCAGCCACGAAAGT
GCAGAAATGTCGACGACCC -> CAGAAATGTCGACGACCCT
TGAGTGGCCCCTCCCACCC -> GAGTGGCCCCTCCCACCCC
CCGACGGACACGAACAAAT -> CGACGGACACGAACAAATG
GTTCAAGAGCTTGCGTTGT -> TTCAAGAGCTTGCGTTGTT
GATAGCCAAATCCGACGCC -> ATAGCCAAATCCGACGCCT
ACCAGGGCGGTACGGGTGT -> CCAGGGCGGTACGGGTGTA
TCATAACTACGGTCTCTTG -> CATAACTACGGTCTCTTGG
CTATGGCAAGTAACGGGGC -> TATGGCAAGTAACGGGGCA
GGGCGGTACGGGTGTACGC -> GGCGGTACGGGTGTACGCA
TGCGTGGCTGACGGTCAAC -> GCGTGGCTGACGGTCAACA
GTACGGGACGCTCCTCAAT -> TACGGGACGCTCCTCAATA
TTATATGCCCTGCCGGAGA -> TATATGCCCTGCCGGAGAG
CAAATCCGACGCCTAGAGC -> AAATCCGACGCCTAGAGCT
CCCGAGTCAAGTAGGCGAC -> CCGAGTCAAGTAGGCGACG
TCTGGGCAATCGGTTTCTA -> CTGGGCAATCGGTTTCTAG
AGTCCGACGGACACGAACA -> GTCCGACGGACACGAACAA
ATGAGCACCCTAGCCCCCA -> TGAGCACCCTAGCCCCCAA
TCGCGCTATGGCAAGTAAC -> CGCGCTATGGCAAGTAACG
GTATAGTACAGGATTAATG -> TATAGTACAGGATTAATGG
TGGTTTGGTCACAAGTTAG -> GGTTTGGTCACAAGTTAGC
AGCAAATGGTGAACAACTA -> GCAAATGGTGAACAACTAC
ACTAGACGGGTAAAGTCGA -> CTAGACGGGTAAAGTCGAG
GAACGACATGCCTCGAGCA -> AACGACATGCCTCGAGCAA
TTCAAGAGCTTGCGTTGTT -> TCAAGAGCTTGCGTTGTTA
ATCTCCAAGTCATGGGTAA -> TCTCCAAGTCATGGGTAAG
CTTTTTGAACGACATGCCT -> TTTTTGAACGACATGCCTC
AATTCCAGCCATTTTCGGA -> ATTCCAGCCATTTTCGGAG
CTCCATCACCAACAAGTAC -> TCCATCACCAACAAGTACC
CTAACGTTGGAGTGAACAA -> TAACGTTGGAGTGAACAAA
GGCTTGAAGCATGCTGCCC -> GCTTGAAGCATGCTGCCCT
CTCATGTGCAACTCTATTC -> TCATGTGCAACTCTATTCG
TTCACCTTGCGCGCGTAGT -> TCACCTTGCGCGCGTAGTA
TGCTGCCCTCCACCAGTCC -> GCTGCCCTCCACCAGTCCT
AAGCTGGTATTGACTAGAC -> AGCTGGTATTGACTAGACG
CGGTCTCTTGGCGACTATG -> GGTCTCTTGGCGACTATGT
GCACTCACGGACCCCCGCA -> CACTCACGGACCCCCGCAC
AGCGGTTGCGATCAAAGAG -> GCGGTTGCGATCAAAGAGA
CGGTACGGGTGTACGCACT -> GGTACGGGTGTACGCACTT
GGAGCAACCCTAGCGTCCG -> GAGCAACCCTAGCGTCCGA
GTAGCCCTCAACAACGTCC -> TAGCCCTCAACAACGTCCA
ATTAAAGCTGTGGTTGAGT -> TTAAAGCTGTGGTTGAGTG
GCTTGTATGTGGTAACCAC -> CTTGTATGTGGTAACCACC
AGACGGGTAAAGTCGAGTT -> GACGGGTAAAGTCGAGTTC
GGGCAGGACAAATGCTTAG -> GGCAGGACAAATGCTTAGA
TTTCGCCCTTCAGTGGTGC -> TTCGCCCTTCAGTGGTGCC
CTGTCGTGAACTCATTCGC -> TGTCGTGAACTCATTCGCG
AGGAAACCAAACAGCCCGA -> GGAAACCAAACAGCCCGAG
TAACGTTGGAGTGAACAAA -> AACGTTGGAGTGAACAAAT
GGCTGACGGTCAACAACTG -> GCTGACGGTCAACAACTGT
CTGCGATTAAAGCTGTGGT -> TGCGATTAAAGCTGTGGTT
CCTCCGATTTCGGCTAGAA -> CTCCGATTTCGGCTAGAAA
GCATACATTTAAGGGTAAA -> CATACATTTAAGGGTAAAT
GTCAAGTAGGCGACGAAAG -> TCAAGTAGGCGACGAAAGC
AGTACAGGATTAATGGCGC -> GTACAGGATTAATGGCGCT
GCAAGTAACGGGGCAGCAC -> CAAGTAACGGGGCAGCACC
GAGTCAAGTAGGCGACGAA -> AGTCAAGTAGGCGACGAAA
GAAAAGGTTATACGTTGTA -> AAAAGGTTATACGTTGTAT
CGCTCCTCAATAAATGTTT -> GCTCCTCAATAAATGTTTG
GGGTAAAGTCGAGTTCGCA -> GGTAAAGTCGAGTTCGCAG
TCCAGCCATTTTCGGAGAT -> CCAGCCATTTTCGGAGATT
TTGGTCACAAGTTAGCACA -> TGGTCACAAGTTAGCACAC
GGCTAGAAACCACATTGCA -> GCTAGAAACCACATTGCAT
CCCTTCAGTGGTGCCGCAA -> CCTTCAGTGGTGCCGCAAG
ATTAAAGTCCGCTTACTCG -> TTAAAGTCCGCTTACTCGT
CGGTACCACACGTTCGCAT -> GGTACCACACGTTCGCATA
ACCCGATCAGTTTGGCCCT -> CCCGATCAGTTTGGCCCTC
AGTACTCAATGGAGGCGTC -> GTACTCAATGGAGGCGTCA
ATCTGTGTCAACGTGCCCT -> TCTGTGTCAACGTGCCCTC
ATGGATGGGTCAGGATTGA -> TGGATGGGTCAGGATTGAA
TAATTGACTTAACCCGATC -> AATTGACTTAACCCGATCA
AGCGTCTGCGATTAAAGCT -> GCGTCTGCGATTAAAGCTG
TGTACGCACTTTTCGCTGC -> GTACGCACTTTTCGCTGCG
TTCCGCAGTGGCCGAACAG -> TCCGCAGTGGCCGAACAGA
TGCATATGCTATTCCGCAG -> GCATATGCTATTCCGCAGT
CACGCCGTTGTCTCGCCCG -> ACGCCGTTGTCTCGCCCGC
TCATTAAGTAAATTCCAGC -> CATTAAGTAAATTCCAGCC
TCTGGGAAGTTAGGGAATT -> CTGGGAAGTTAGGGAATTT
GCTTAGAACAAATGGAGTT -> CTTAGAACAAATGGAGTTG
GCGGAGGCAGAAGTTGCGC -> CGGAGGCAGAAGTTGCGCA
GCTGGGAGTATGTCCTCTG -> CTGGGAGTATGTCCTCTGC
TTGTCGGGTATACGTGCAG -> TGTCGGGTATACGTGCAGC
AATGCTTAGAACAAATGGA -> ATGCTTAGAACAAATGGAG
AAATGGAGTTGTCTTACGC -> AATGGAGTTGTCTTACGCG
GCGAGAGCGAATCAACCAC -> CGAGAGCGAATCAACCACA
GCTAGAAACCACATTGCAT -> CTAGAAACCACATTGCATC
GGTCACAAGTTAGCACACA -> GTCACAAGTTAGCACACAC
CAAATGGAGTTGTCTTACG -> AAATGGAGTTGTCTTACGC
CAAATGGAGTTGTCTCAAG -> AAATGGAGTTGTCTCAAGC
CCGCTTACTCGTCCGACGG -> CGCTTACTCGTCCGACGGC
TGGCATGCAAGGCTTGAAG -> GGCATGCAAGGCTTGAAGC
TAGTCAGTTCGGTACCACA -> AGTCAGTTCGGTACCACAC
CGAGTTACCAGAATCGACG -> GAGTTACCAGAATCGACGC
AAATGGTGAACAACTACAA -> AATGGTGAACAACTACAAC
GCAACCCTAGCGTCCGATA -> CAACCCTAGCGTCCGATAA
AGTACCCCGTCACCCTTCC -> GTACCCCGTCACCCTTCCT
AGTTGTCTTACGCGGGACC -> GTTGTCTTACGCGGGACCG
GTGGCCCCTCCCACCCCTG -> TGGCCCCTCCCACCCCTGC
TAGTCCTGGCACTTAGCGA -> AGTCCTGGCACTTAGCGAA
TCAACCACAGTTCAAGAGC -> CAACCACAGTTCAAGAGCT
CTGCCCTCCACCAGTCCTC -> TGCCCTCCACCAGTCCTCA
CAGTGGCCGAACAGAGCCG -> AGTGGCCGAACAGAGCCGA
GTACAGGATTAATGGCGCT -> TACAGGATTAATGGCGCTC
CTGTAGCCCTCAACAACGT -> TGTAGCCCTCAACAACGTC
ACAATAGGTTAGTTGCAGG -> CAATAGGTTAGTTGCAGGA
AGTTCATTAAGTAAATTCC -> GTTCATTAAGTAAATTCCA
AGAGATGGGTCAAACAAGA -> GAGATGGGTCAAACAAGAT
ATATTCAAGTACGGGACGC -> TATTCAAGTACGGGACGCT
ACGGTCAACAACTGTGCTC -> CGGTCAACAACTGTGCTCC
CTGTGGTTGAGTGGCCCCT -> TGTGGTTGAGTGGCCCCTC
GTTGCAGGAGCAACCCTAG -> TTGCAGGAGCAACCCTAGC
GGAGTTGTCTCAAGCAGAG -> GAGTTGTCTCAAGCAGAGT
GGTCAAGAGACACCGCGGC -> GTCAAGAGACACCGCGGCG
CTCCCGCCCTACGATCTGT -> TCCCGCCCTACGATCTGTG
AGCCCGAGCGGTTGCGATC -> GCCCGAGCGGTTGCGATCA
CTTGCGCTCATGTGCAACT -> TTGCGCTCATGTGCAACTC
TTGAAATTCTGCACGATCG -> TGAAATTCTGCACGATCGA
ATGTCGACGACCCTTGCCG -> TGTCGACGACCCTTGCCGA
CAAGGCTTGAAGCATGCTG -> AAGGCTTGAAGCATGCTGC
TGAGGGCATAGCTCAGTCA -> GAGGGCATAGCTCAGTCAT
GCCCGAGTCAAGTAGGCGA -> CCCGAGTCAAGTAGGCGAC
TTGCGATCAAAGAGATGGT -> TGCGATCAAAGAGATGGTT
TACGCGGGACCGAATTTCG -> ACGCGGGACCGAATTTCGC
ATAGTACAGGATTAATGGC -> TAGTACAGGATTAATGGCG
CGATCTGTGTCAACGTGCC -> GATCTGTGTCAACGTGCCC
ATTCTTGCGGAATTAAGTA -> TTCTTGCGGAATTAAGTAG
GGCCCTCCGATTTCGGCTA -> GCCCTCCGATTTCGGCTAG
GCACTCAAACGTCAAGCAA -> CACTCAAACGTCAAGCAAT
CAGTGGTGCCGCAAGTAGA -> AGTGGTGCCGCAAGTAGAT
GGTTAGGCAGAAATGTCGA -> GTTAGGCAGAAATGTCGAC
CGGCACTAAGCTGGTATTG -> GGCACTAAGCTGGTATTGA
CGTTCCAAAGACCTGGGAT -> GTTCCAAAGACCTGGGATG
AGATCAGCCACAACTCGCG -> GATCAGCCACAACTCGCGC
TGGTAACCACCATTAAAGT -> GGTAACCACCATTAAAGTC
GGCATGCAAGGCTTGAAGC -> GCATGCAAGGCTTGAAGCA
TGGCGCTCTCAGGGGTCGT -> GGCGCTCTCAGGGGTCGTT
CGGCTCCCGCCCTACGATC -> GGCTCCCGCCCTACGATCT
GTTCGGTACCACACGTTCG -> TTCGGTACCACACGTTCGC
TTACCAGAATCGACGCTGG -> TACCAGAATCGACGCTGGA
ATTCGCGGCACACTACATG -> TTCGCGGCACACTACATGG
GAGCAACCCTAGCGTCCGA -> AGCAACCCTAGCGTCCGAT
CCGAGCGGTTGCGATCAAA -> CGAGCGGTTGCGATCAAAG
GTGGGGAATTTCGCCCTTC -> TGGGGAATTTCGCCCTTCA
GGTACGGGTGTACGCACTT -> GTACGGGTGTACGCACTTT
TCAGTTCGGTACCACACGT -> CAGTTCGGTACCACACGTT
CGCCTAGAGCTCTGACCAC -> GCCTAGAGCTCTGACCACC
TAGCGTCCGATAAATAAGA -> AGCGTCCGATAAATAAGAC
CACTCACGGACCCCCGCAC -> ACTCACGGACCCCCGCACG
GTTATAGTCCTGGCACTTA -> TTATAGTCCTGGCACTTAG
TAGGAAAAGGTTATACGTT -> AGGAAAAGGTTATACGTTG
AATCTGGGCAATCGGTTTC -> ATCTGGGCAATCGGTTTCT
CTAGAAACCACATTGCATC -> TAGAAACCACATTGCATCT
GGAGTGAACAAATGGAGTT -> GAGTGAACAAATGGAGTTG
ATTAATGGCGCTCTCAGGG -> TTAATGGCGCTCTCAGGGG
GAAGTTGCGCATGCTTGCG -> AAGTTGCGCATGCTTGCGC
GCATGCTTGCGCTCATGTG -> CATGCTTGCGCTCATGTGC
CTCAATAAATGTTTGGTCG -> TCAATAAATGTTTGGTCGG
CGTATTCAGTACTCAATGG -> GTATTCAGTACTCAATGGA
CGACATGCCTCGAGCAAAG -> GACATGCCTCGAGCAAAGA
ACGGCTTCTGCGACGATGG -> CGGCTTCTGCGACGATGGT
TTGCCGATACAGCTCCACA -> TGCCGATACAGCTCCACAT
GGTTGCGATCAAAGAGATG -> GTTGCGATCAAAGAGATGG
CACACGTTCGCATATTCAA -> ACACGTTCGCATATTCAAG
CAATGCACACGCCGTTGTC -> AATGCACACGCCGTTGTCT
CGCGGGTGTCACTTGGTAG -> GCGGGTGTCACTTGGTAGT
GAAGTTAGGGAATTTCGCC -> AAGTTAGGGAATTTCGCCC
TAGATATGGGCAGCCACGA -> AGATATGGGCAGCCACGAA
GATTTCGGCTAGAAACCAC -> ATTTCGGCTAGAAACCACA
TCCCACCCCTGCTGGGAGT -> CCCACCCCTGCTGGGAGTA
TGGAGTTGTCTTACGCGGG -> GGAGTTGTCTTACGCGGGA
TTTTTTGTTGTCTCGTCCG -> TTTTTGTTGTCTCGTCCGT
GACTTTTTGAACGACATGC -> ACTTTTTGAACGACATGCC
TGTAATTGACTTAACCCGA -> GTAATTGACTTAACCCGAT
CGCCATCTCATAACTACGG -> GCCATCTCATAACTACGGT
GGAGGAGCTCAATGACCCG -> GAGGAGCTCAATGACCCGT
TCCTGGATGACTTGTCGGG -> CCTGGATGACTTGTCGGGT
GCATGCAAGGCTTGAAGCA -> CATGCAAGGCTTGAAGCAT
CAATGCTAAATAAACATGC -> AATGCTAAATAAACATGCA
GCGTCCGATAAATAAGACG -> CGTCCGATAAATAAGACGC
TGGGAAGTTAGGGAATTTC -> GGGAAGTTAGGGAATTTCG
AACCACATTGCATCTCCAA -> ACCACATTGCATCTCCAAG
CAACCCTAGCGTCCGATAA -> AACCCTAGCGTCCGATAAA
ATGCTGCCCTCCACCAGTC -> TGCTGCCCTCCACCAGTCC
GGGTCAGGATTGAAATTCT -> GGTCAGGATTGAAATTCTG
CTACGGTCTCTTGGCGACT -> TACGGTCTCTTGGCGACTA
GGTACCACACGTTCGCATA -> GTACCACACGTTCGCATAT
CACTCAAACGTCAAGCAAT -> ACTCAAACGTCAAGCAATC
GCGGCGCATACAGTGGTAA -> CGGCGCATACAGTGGTAAG
TCAAGTAGGCGACGAAAGC -> CAAGTAGGCGACGAAAGCG
GCGTGGCTGACGGTCAACA -> CGTGGCTGACGGTCAACAA
AGCCGAGTTACCAGAATCG -> GCCGAGTTACCAGAATCGA
CGCCTGCACAGGGCTTCTC -> GCCTGCACAGGGCTTCTCG
CGATGGTTTGGTCACAAGT -> GATGGTTTGGTCACAAGTT
TCAACAACGTCCAACGCGC -> CAACAACGTCCAACGCGCA
ACGACCCTTGCCGATACAG -> CGACCCTTGCCGATACAGC
AATGACCCGTTTTTGAGGG -> ATGACCCGTTTTTGAGGGC
GATCGCCGCGACGCGGAGG -> ATCGCCGCGACGCGGAGGC
AGTTGTCTCAAGCAGAGTG -> GTTGTCTCAAGCAGAGTGG
CTGCACGATCGACATTCTA -> TGCACGATCGACATTCTAC
TCGTCCGACGGCTTCTGCG -> CGTCCGACGGCTTCTGCGA
ACAACTACAACAGTTCATC -> CAACTACAACAGTTCATCA
CGACGACCCTTGCCGATAC -> GACGACCCTTGCCGATACA
CCGCGGCGCATACAGTGGT -> CGCGGCGCATACAGTGGTA
CTTAGCGAAAGAAATCGGC -> TTAGCGAAAGAAATCGGCT
CACCATTAAAGTCCGCTTA -> ACCATTAAAGTCCGCTTAC
TTAACCCGATCAGTTTGGC -> TAACCCGATCAGTTTGGCC
AAGCGTCTGCGATTAAAGC -> AGCGTCTGCGATTAAAGCT
AGAGCTCTGACCACCGGCC -> GAGCTCTGACCACCGGCCT
CTGTCTCGTTTCTGTATGA -> TGTCTCGTTTCTGTATGAG
AGCACACACGTGGTTACGT -> GCACACACGTGGTTACGTC
GAGCACCCTAGCCCCCAAG -> AGCACCCTAGCCCCCAAGC
CCCAATATTGCGATTTTTA -> CCAATATTGCGATTTTTAG
CAATGAGCAAATGGTGAAC -> AATGAGCAAATGGTGAACA
AGCCTGAAGTCTCCCTCTG -> GCCTGAAGTCTCCCTCTGT
TGTGGTTGAGTGGCCCCTC -> GTGGTTGAGTGGCCCCTCC
GATACCGATAGTGTAGCGG -> ATACCGATAGTGTAGCGGT
AGTAGGCGACGAAAGCGTC -> GTAGGCGACGAAAGCGTCT
AAAGTCCGCTTACTCGTCC -> AAGTCCGCTTACTCGTCCG
CGCCCTTCAGTGGGCGCAA -> GCCCTTCAGTGGGCGCAAG
AGCCGCCCGAGTCAAGTAG -> GCCGCCCGAGTCAAGTAGG
GTTCATCAATGCACACGCC -> TTCATCAATGCACACGCCG
TTGAACGACATGCCTCGAG -> TGAACGACATGCCTCGAGC
AACAAGATTAAGAGCACTC -> ACAAGATTAAGAGCACTCA
AATCCCACAGTCCGACGGA -> ATCCCACAGTCCGACGGAC
CGCGGAGGCAGAAGTTGCG -> GCGGAGGCAGAAGTTGCGC
CTTGCCGATACAGCTCCAC -> TTGCCGATACAGCTCCACA
ACGGTCTCTTGGCGACTAT -> CGGTCTCTTGGCGACTATG
TGCATGCATACATTTAAGG -> GCATGCATACATTTAAGGG
TCTGACCACCGGCCTTAGA -> CTGACCACCGGCCTTAGAA
GAACTCATTCGCGGCACAC -> AACTCATTCGCGGCACACT
TAAATAAGACGCAATGCTA -> AAATAAGACGCAATGCTAA
ATAGTGTAGCGGTCACCCA -> TAGTGTAGCGGTCACCCAA
CAAATGGAGTTGTCTAACG -> AAATGGAGTTGTCTAACGT
CTAAGCTGGTATTGACTAG -> TAAGCTGGTATTGACTAGA
CATAGTTCATTAAGTAAAT -> ATAGTTCATTAAGTAAATT
ATTCTACATAAAGTCAGTT -> TTCTACATAAAGTCAGTTA
CGTCCTCCTCGGTGTAATT -> GTCCTCCTCGGTGTAATTG
AGGATTAATGGCGCTCTCA -> GGATTAATGGCGCTCTCAG
GCGGAATTAAGTAGATATG -> CGGAATTAAGTAGATATGG
GGAACGGAGGAGCTCAATG -> GAACGGAGGAGCTCAATGA
CGTCCGATAAATAAGACGC -> GTCCGATAAATAAGACGCA
AGGCGTCAGTAATTCATTC -> GGCGTCAGTAATTCATTCC
GCAGTGGCCGAACAGAGCC -> CAGTGGCCGAACAGAGCCG
CACCCTTCCTGGATGACTT -> ACCCTTCCTGGATGACTTG
TATTCGCAGATAGCCAAAT -> ATTCGCAGATAGCCAAATC
GCTGGAACAAATGGAGTTG -> CTGGAACAAATGGAGTTGT
TCACCCTTCCTGGATGACT -> CACCCTTCCTGGATGACTT
TTAGCACACACGTGGTTAC -> TAGCACACACGTGGTTACG
CCACCAGTCCTCATGAAAG -> CACCAGTCCTCATGAAAGA
TGCTCCTTTTTTTGTTGTC -> GCTCCTTTTTTTGTTGTCT
TGGCACTTAGCGAAAGAAA -> GGCACTTAGCGAAAGAAAT
GCGGTCACCCAATATTGCG -> CGGTCACCCAATATTGCGA
GTCTCTTGGCGACTATGTG -> TCTCTTGGCGACTATGTGT
TAGTTGCAGGAGCAACCCT -> AGTTGCAGGAGCAACCCTA
CGCCGTTGTCTCGCCCGCG -> GCCGTTGTCTCGCCCGCGT
AAGATGAGCCACGTATTCA -> AGATGAGCCACGTATTCAG
GCTCTCAGGGGTCGTTGGT -> CTCTCAGGGGTCGTTGGTT
GTGCAGCCGCCCGAGTCAA -> TGCAGCCGCCCGAGTCAAG
TGCTTGCGCTCATGTGCAA -> GCTTGCGCTCATGTGCAAC
TACAATAGGTTAGTTGCAG -> ACAATAGGTTAGTTGCAGG
TTCTGTATGAGCACCCTAG -> TCTGTATGAGCACCCTAGC
GGCTTCTCGATCTACAGGG -> GCTTCTCGATCTACAGGGT
AACATGCATATGCTATTCC -> ACATGCATATGCTATTCCG
TCGCATATTCAAGTACGGG -> CGCATATTCAAGTACGGGA
CCGAGTTACCAGAATCGAC -> CGAGTTACCAGAATCGACG
AACAAATGGAGTTGTCTTA -> ACAAATGGAGTTGTCTTAC
GCACCTGCGTTGATAGCGC -> CACCTGCGTTGATAGCGCT
GGCACTCACGGACCCCCGC -> GCACTCACGGACCCCCGCA
AAGCATGCTGCCCTCCACC -> AGCATGCTGCCCTCCACCA
GAGGGCATAGCTCAGTCAT -> AGGGCATAGCTCAGTCATA
GAAATCGGCTCCCGCCCTA -> AAATCGGCTCCCGCCCTAC
AGAAATGTCGACGACCCTT -> GAAATGTCGACGACCCTTG
CCTGTCTCGTTTCTGTATG -> CTGTCTCGTTTCTGTATGA
CCCGCCCTACGATCTGTGT -> CCGCCCTACGATCTGTGTC
CCGCAGTGGCCGAACAGAG -> CGCAGTGGCCGAACAGAGC
AAAGACAAGCACACTGTCA -> AAGACAAGCACACTGTCAT
AGGGTAAATTACTATTTGG -> GGGTAAATTACTATTTGGC
GACCACCGGCCTTAGAATA -> ACCACCGGCCTTAGAATAG
CATGGATGGGTCAGGATTG -> ATGGATGGGTCAGGATTGA
TAACCACCATTAAAGTCCG -> AACCACCATTAAAGTCCGC
ATTGACTAGACGGGTAAAG -> TTGACTAGACGGGTAAAGT
ATTTCGCCCTTCAGTGGTG -> TTTCGCCCTTCAGTGGTGC
CGAACAGAGCCGAGTTACC -> GAACAGAGCCGAGTTACCA
TGCCGCAAGTAGATACCGA -> GCCGCAAGTAGATACCGAT
GTATTGACTAGACGGGTAA -> TATTGACTAGACGGGTAAA
CCGATTTCGGCTAGAAACC -> CGATTTCGGCTAGAAACCA
ATGCAAGGCTTGAAGCATG -> TGCAAGGCTTGAAGCATGC
GATAGTGTAGCGGTCACCC -> ATAGTGTAGCGGTCACCCA
CACACGTGGTTACGTCCTC -> ACACGTGGTTACGTCCTCC
CCGACGCCTAGAGCTCTGA -> CGACGCCTAGAGCTCTGAC
CTTACGCGGGACCGAATTT -> TTACGCGGGACCGAATTTC
CAGAAGTTGCGCATGCTTG -> AGAAGTTGCGCATGCTTGC
CCCTGCCGGAGAGACATGA -> CCTGCCGGAGAGACATGAT
ATTCGCAGATAGCCAAATC -> TTCGCAGATAGCCAAATCC
GCTCAGTCATAGTTCATTA -> CTCAGTCATAGTTCATTAA
CAGCTCCACATGCGTTCCA -> AGCTCCACATGCGTTCCAA
TCGGGAACGGAGGAGCTCA -> CGGGAACGGAGGAGCTCAA
GTGTGATTGAATATAGAGA -> TGTGATTGAATATAGAGAT
TTTCGCCCTTCAGTGGGCG -> TTCGCCCTTCAGTGGGCGC
GACATTCTACATAAAGTCA -> ACATTCTACATAAAGTCAG
TCAAGAGCTTGCGTTGTTA -> CAAGAGCTTGCGTTGTTAT
TAGCACACACGTGGTTACG -> AGCACACACGTGGTTACGT
TAAGCCCACAGTCCTGTCT -> AAGCCCACAGTCCTGTCTC
GGCAGCACCTGCGTTGATA -> GCAGCACCTGCGTTGATAG
CCACATTGCATCTCCAAGT -> CACATTGCATCTCCAAGTC
CAAACAGCCCGAGCGGTTG -> AAACAGCCCGAGCGGTTGC
TTCAGTGGGGAATTTCGCC -> TCAGTGGGGAATTTCGCCC
CCGCCCTACGATCTGTGTC -> CGCCCTACGATCTGTGTCA
GTCAGGATTGAAATTCTGC -> TCAGGATTGAAATTCTGCA
GTCGTTGGTTAGGCAGAAA -> TCGTTGGTTAGGCAGAAAT
CTCTGCAATGAGCAAATGG -> TCTGCAATGAGCAAATGGT
CTTGGCGACTATGTGTGAT -> TTGGCGACTATGTGTGATT
TTTTAGTCAGTTCGGTACC -> TTTAGTCAGTTCGGTACCA
CGGCTTCTGCGACGATGGT -> GGCTTCTGCGACGATGGTT
GCATCTCCAAGTCATGGGT -> CATCTCCAAGTCATGGGTA
AAGGTTATACGTTGTATAG -> AGGTTATACGTTGTATAGT
GACGGTCAACAACTGTGCT -> ACGGTCAACAACTGTGCTC
ACGCGGAGGCAGAAGTTGC -> CGCGGAGGCAGAAGTTGCG
TGTGCTCCTTTTTTTGTTG -> GTGCTCCTTTTTTTGTTGT
GTAAATTCCAGCCATTTTC -> TAAATTCCAGCCATTTTCG
CAGTTACCAGACCAGGGCG -> AGTTACCAGACCAGGGCGG
CGATTTCGGCTAGAAACCA -> GATTTCGGCTAGAAACCAC
GCAGATAGCCAAATCCGAC -> CAGATAGCCAAATCCGACG
GACTTGTCGGGTATACGTG -> ACTTGTCGGGTATACGTGC
GTTGAGTGGCCCCTCCCAC -> TTGAGTGGCCCCTCCCACC
CCCCGCACGACGCGAGAGC -> CCCGCACGACGCGAGAGCG
GTTGTCTAACGTTGGAGTG -> TTGTCTAACGTTGGAGTGA
TCAGTGGGCGCAAGGAAAC -> CAGTGGGCGCAAGGAAACC
TCATTATATGCCCTGCCGG -> CATTATATGCCCTGCCGGA
CGATTAAAGCTGTGGTTGA -> GATTAAAGCTGTGGTTGAG
GATGTACAATAGGTTAGTT -> ATGTACAATAGGTTAGTTG
TAAGAGCACTCAAACGTCA -> AAGAGCACTCAAACGTCAA
AGCCACGTATTCAGTACTC -> GCCACGTATTCAGTACTCA
CAGGGCTTCTCGATCTACA -> AGGGCTTCTCGATCTACAG
CAGTTCAAGAGCTTGCGTT -> AGTTCAAGAGCTTGCGTTG
ATGGTGAACAACTACAACA -> TGGTGAACAACTACAACAG
CGTCAGTAATTCATTCCTG -> GTCAGTAATTCATTCCTGT
GTCACCCTTCCTGGATGAC -> TCACCCTTCCTGGATGACT
TTAGAATAGAGCTCCATCA -> TAGAATAGAGCTCCATCAC
ACTTAGCGAAAGAAATCGG -> CTTAGCGAAAGAAATCGGC
ACATTGCATCTCCAAGTCA -> CATTGCATCTCCAAGTCAT
GCAATGAGCAAATGGTGAA -> CAATGAGCAAATGGTGAAC
GTCAACGTGCCCTCGGGAA -> TCAACGTGCCCTCGGGAAC
GGTCGTTGGTTAGGCAGAA -> GTCGTTGGTTAGGCAGAAA
CATGCATATGCTATTCCGC -> ATGCATATGCTATTCCGCA
CGAGTTCGCAGACTTTGCA -> GAGTTCGCAGACTTTGCAT
AACAAATGGAGTTGTCTCA -> ACAAATGGAGTTGTCTCAA
TGCACGATCGACATTCTAC -> GCACGATCGACATTCTACA
CGAAAGAAATCGGCTCCCG -> GAAAGAAATCGGCTCCCGC
AGAGATGGTTCACCTTGCG -> GAGATGGTTCACCTTGCGC
CGCTCTCAGGGGTCGTTGG -> GCTCTCAGGGGTCGTTGGT
TGGATGACTTGTCGGGTAT -> GGATGACTTGTCGGGTATA
AGCTCAGTCATAGTTCATT -> GCTCAGTCATAGTTCATTA
TGTCTTACGCGGGACCGAA -> GTCTTACGCGGGACCGAAT
ATGTGGTAACCACCATTAA -> TGTGGTAACCACCATTAAA
AGTAAATTCCAGCCATTTT -> GTAAATTCCAGCCATTTTC
GGCAATCGGTTTCTAGCCT -> GCAATCGGTTTCTAGCCTA
CATCAATGCACACGCCGTT -> ATCAATGCACACGCCGTTG
CCTAGCCCCCAAGCTTGTA -> CTAGCCCCCAAGCTTGTAT
TCGCCGCGACGCGGAGGCA -> CGCCGCGACGCGGAGGCAG
GCGGTACGGGTGTACGCAC -> CGGTACGGGTGTACGCACT
CAAGTACGGGACGCTCCTC -> AAGTACGGGACGCTCCTCA
ATTCATTCCTGTAGCCCTC -> TTCATTCCTGTAGCCCTCA
CGCGGCGCATACAGTGGTA -> GCGGCGCATACAGTGGTAA
CGTTTTTGAGGGCATAGCT -> GTTTTTGAGGGCATAGCTC
ATACCGATGGACGCCATCT -> TACCGATGGACGCCATCTC
AATTGACTTAACCCGATCA -> ATTGACTTAACCCGATCAG
GCGTTGTTATAGTCCTGGC -> CGTTGTTATAGTCCTGGCA
AGCGAAAGAAATCGGCTCC -> GCGAAAGAAATCGGCTCCC
GTAACGGGGCAGCACCTGC -> TAACGGGGCAGCACCTGCG
CAGTAATTCATTCCTGTAG -> AGTAATTCATTCCTGTAGC
GCAATGCTAAATAAACATG -> CAATGCTAAATAAACATGC
ACTCAAACGTCAAGCAATC -> CTCAAACGTCAAGCAATCT
CACCCAATATTGCGATTTT -> ACCCAATATTGCGATTTTT
CGACGCGAGAGCGAATCAA -> GACGCGAGAGCGAATCAAC
TCAAACGTCAAGCAATCTG -> CAAACGTCAAGCAATCTGG
ACAACTCGCGCTATGGCAA -> CAACTCGCGCTATGGCAAG
GCACGATCGACATTCTACA -> CACGATCGACATTCTACAT
TCAGTAATTCATTCCTGTA -> CAGTAATTCATTCCTGTAG
ATAGCGCTTATCGCGGGTG -> TAGCGCTTATCGCGGGTGT
AAAGCGTCTGCGATTAAAG -> AAGCGTCTGCGATTAAAGC
ATAGTTCATTAAGTAAATT -> TAGTTCATTAAGTAAATTC
TTGTCTTACGCGGGACCGA -> TGTCTTACGCGGGACCGAA
CGCAGATCAGCCACAACTC -> GCAGATCAGCCACAACTCG
GTAGACTTTTTGAACGACA -> TAGACTTTTTGAACGACAT
GCCCCCAAGCTTGTATGTG -> CCCCCAAGCTTGTATGTGG
TCCTCGGTGTAATTGACTT -> CCTCGGTGTAATTGACTTA
TTTCGGCTAGAAACCACAT -> TTCGGCTAGAAACCACATT
CCCTTCAGTGGGGAATTTC -> CCTTCAGTGGGGAATTTCG
CCCTAGCGTCCGATAAATA -> CCTAGCGTCCGATAAATAA
CACTTAGCGAAAGAAATCG -> ACTTAGCGAAAGAAATCGG
TTGGAGTGAACAAATGGAG -> TGGAGTGAACAAATGGAGT
CAAACGTCAAGCAATCTGG -> AAACGTCAAGCAATCTGGG
AGACTTTGCATGCATACAT -> GACTTTGCATGCATACATT
AAGTTAGGGAATTTCGCCC -> AGTTAGGGAATTTCGCCCT
TAATCCCACAGTCCGACGG -> AATCCCACAGTCCGACGGA
CATATGCTATTCCGCAGTG -> ATATGCTATTCCGCAGTGG
ATTTGGCACTCACGGACCC -> TTTGGCACTCACGGACCCC
TAATGGCGCTCTCAGGGGT -> AATGGCGCTCTCAGGGGTC
TAAGCTGGTATTGACTAGA -> AAGCTGGTATTGACTAGAC
GGTCAAACAAGATTAAGAG -> GTCAAACAAGATTAAGAGC
AAGGCTTGAAGCATGCTGC -> AGGCTTGAAGCATGCTGCC
AACTACGGTCTCTTGGCGA -> ACTACGGTCTCTTGGCGAC
GACGATGGTTTGGTCACAA -> ACGATGGTTTGGTCACAAG
ATGTCCTCTGCAATGAGCA -> TGTCCTCTGCAATGAGCAA
CAGTACTCAATGGAGGCGT -> AGTACTCAATGGAGGCGTC
TTCTAGCCTAGGAAAAGGT -> TCTAGCCTAGGAAAAGGTT
AACCACCATTAAAGTCCGC -> ACCACCATTAAAGTCCGCT
GTGCCCTCGGGAACGGAGG -> TGCCCTCGGGAACGGAGGA
GTTAGGCAGAAATGTCGAC -> TTAGGCAGAAATGTCGACG
GACACCGCGGCGCATACAG -> ACACCGCGGCGCATACAGT
ACCCTTCCTGGATGACTTG -> CCCTTCCTGGATGACTTGT
GCCCTACGATCTGTGTCAA -> CCCTACGATCTGTGTCAAC
ATCGACATTCTACATAAAG -> TCGACATTCTACATAAAGT
CACCGCGGCGCATACAGTG -> ACCGCGGCGCATACAGTGG
GTCTCGTCCGTGTAATCCC -> TCTCGTCCGTGTAATCCCA
TCTTGGCGACTATGTGTGA -> CTTGGCGACTATGTGTGAT
GACGGGTAAAGTCGAGTTC -> ACGGGTAAAGTCGAGTTCG
CTTGTCGGGTATACGTGCA -> TTGTCGGGTATACGTGCAG
AACAGTTCATCAATGCACA -> ACAGTTCATCAATGCACAC
ATGCATATGCTATTCCGCA -> TGCATATGCTATTCCGCAG
CAGAGTGGAATTTCGCCCT -> AGAGTGGAATTTCGCCCTT
CTTGTATGTGGTAACCACC -> TTGTATGTGGTAACCACCA
AGATATGGGCAGCCACGAA -> GATATGGGCAGCCACGAAA
AGAGCTTGCGTTGTTATAG -> GAGCTTGCGTTGTTATAGT
CAGAGCCGAGTTACCAGAA -> AGAGCCGAGTTACCAGAAT
GCCCGCGTATGGGGCAGGA -> CCCGCGTATGGGGCAGGAC
AGATTCTTGCGGAATTAAG -> GATTCTTGCGGAATTAAGT
AAACAAGATTAAGAGCACT -> AACAAGATTAAGAGCACTC
TTGTCTAACGTTGGAGTGA -> TGTCTAACGTTGGAGTGAA
CTCGATCTACAGGGTCAAG -> TCGATCTACAGGGTCAAGA
CTCTGACCACCGGCCTTAG -> TCTGACCACCGGCCTTAGA
TCCACCAGTCCTCATGAAA -> CCACCAGTCCTCATGAAAG
AGAAACCACATTGCATCTC -> GAAACCACATTGCATCTCC
CTACATGGATGGGTCAGGA -> TACATGGATGGGTCAGGAT
ACAGTGGTAAGCCCACAGT -> CAGTGGTAAGCCCACAGTC
CCACCATTAAAGTCCGCTT -> CACCATTAAAGTCCGCTTA
AACGTTGGAGTGAACAAAT -> ACGTTGGAGTGAACAAATG
AACTCGCGCTATGGCAAGT -> ACTCGCGCTATGGCAAGTA
TCAGTACTCAATGGAGGCG -> CAGTACTCAATGGAGGCGT
AATCGGTTTCTAGCCTAGG -> ATCGGTTTCTAGCCTAGGA
TGGCCGAACAGAGCCGAGT -> GGCCGAACAGAGCCGAGTT
ACGTCAAGCAATCTGGGCA -> CGTCAAGCAATCTGGGCAA
GAGTTGTCTTACGCGGGAC -> AGTTGTCTTACGCGGGACC
CAAGTACCCCGTCACCCTT -> AAGTACCCCGTCACCCTTC
CGGGGCAGCACCTGCGTTG -> GGGGCAGCACCTGCGTTGA
TTTTTGAACGACATGCCTC -> TTTTGAACGACATGCCTCG
TCGACGCTGGAACAAATGG -> CGACGCTGGAACAAATGGA
AAACCAAACAGCCCGAGCG -> AACCAAACAGCCCGAGCGG
CCAGGGCGGTACGGGTGTA -> CAGGGCGGTACGGGTGTAC
CGACGCCTAGAGCTCTGAC -> GACGCCTAGAGCTCTGACC
GCTCCTCAATAAATGTTTG -> CTCCTCAATAAATGTTTGG
GGTTAGTTGCAGGAGCAAC -> GTTAGTTGCAGGAGCAACC
CAAGTAGGCGACGAAAGCG -> AAGTAGGCGACGAAAGCGT
TTAAGTAAATTCCAGCCAT -> TAAGTAAATTCCAGCCATT
TTAGCGAAAGAAATCGGCT -> TAGCGAAAGAAATCGGCTC
AGCTTGTATGTGGTAACCA -> GCTTGTATGTGGTAACCAC
TTAATGGCGCTCTCAGGGG -> TAATGGCGCTCTCAGGGGT
ATAGTCCTGGCACTTAGCG -> TAGTCCTGGCACTTAGCGA
CGTATGGGGCAGGACAAAT -> GTATGGGGCAGGACAAATG
GTACTCAATGGAGGCGTCA -> TACTCAATGGAGGCGTCAG
GGCGCTCTCAGGGGTCGTT -> GCGCTCTCAGGGGTCGTTG
TTTGGTCGGCACTAAGCTG -> TTGGTCGGCACTAAGCTGG
ATGTACAATAGGTTAGTTG -> TGTACAATAGGTTAGTTGC
CGACGCGGAGGCAGAAGTT -> GACGCGGAGGCAGAAGTTG
TCCAACGCGCAGATCAGCC -> CCAACGCGCAGATCAGCCA
ATAAATAAGACGCAATGCT -> TAAATAAGACGCAATGCTA
TGGTTACGTCCTCCTCGGT -> GGTTACGTCCTCCTCGGTG
TTCTGCGACGATGGTTTGG -> TCTGCGACGATGGTTTGGT
CTTTGCATGCATACATTTA -> TTTGCATGCATACATTTAA
GCTTGAAGCATGCTGCCCT -> CTTGAAGCATGCTGCCCTC
GCAGCCACGAAAGTAGACT -> CAGCCACGAAAGTAGACTT
CGCTTACTCGTCCGACGGC -> GCTTACTCGTCCGACGGCT
GGCATAGCTCAGTCATAGT -> GCATAGCTCAGTCATAGTT
GAATAGAGCTCCATCACCA -> AATAGAGCTCCATCACCAA
CCCTAGCCCCCAAGCTTGT -> CCTAGCCCCCAAGCTTGTA
ACACACGTGGTTACGTCCT -> CACACGTGGTTACGTCCTC
ATGGTTCACCTTGCGCGCG -> TGGTTCACCTTGCGCGCGT
ACCAGTCCTCATGAAAGAC -> CCAGTCCTCATGAAAGACA
ACCCGTTTTTGAGGGCATA -> CCCGTTTTTGAGGGCATAG
CAAGCAGAGTGGAATTTCG -> AAGCAGAGTGGAATTTCGC
TTCAGTGGGCGCAAGGAAA -> TCAGTGGGCGCAAGGAAAC
GATGAGCCACGTATTCAGT -> ATGAGCCACGTATTCAGTA
GGCGCATACAGTGGTAAGC -> GCGCATACAGTGGTAAGCC
GGTGTACGCACTTTTCGCT -> GTGTACGCACTTTTCGCTG
CGAGCAAAGATGAGCCACG -> GAGCAAAGATGAGCCACGT
AGCTTGCGTTGTTATAGTC -> GCTTGCGTTGTTATAGTCC
GTTACCAGACCAGGGCGGT -> TTACCAGACCAGGGCGGTA
AGCACCCTAGCCCCCAAGC -> GCACCCTAGCCCCCAAGCT
ATGCCTCGAGCAAAGATGA -> TGCCTCGAGCAAAGATGAG
CGCTCATGTGCAACTCTAT -> GCTCATGTGCAACTCTATT
GGCAGCCACGAAAGTAGAC -> GCAGCCACGAAAGTAGACT
CAGTGGTAAGCCCACAGTC -> AGTGGTAAGCCCACAGTCC
AAGATTAAGAGCACTCAAA -> AGATTAAGAGCACTCAAAC
AGACGCAATGCTAAATAAA -> GACGCAATGCTAAATAAAC
AACGTCAAGCAATCTGGGC -> ACGTCAAGCAATCTGGGCA
CGACCCTTGCCGATACAGC -> GACCCTTGCCGATACAGCT
GTAGATATGGGCAGCCACG -> TAGATATGGGCAGCCACGA
ATAGAGCTCCATCACCAAC -> TAGAGCTCCATCACCAACA
GTCCTGTCTCGTTTCTGTA -> TCCTGTCTCGTTTCTGTAT
GCACGACGCGAGAGCGAAT -> CACGACGCGAGAGCGAATC
AGTTAGCACACACGTGGTT -> GTTAGCACACACGTGGTTA
GCCCTTCAGTGGTGCCGCA -> CCCTTCAGTGGTGCCGCAA
AACCCGATCAGTTTGGCCC -> ACCCGATCAGTTTGGCCCT
TCCCACAGTCCGACGGACA -> CCCACAGTCCGACGGACAC
CTCAACAACGTCCAACGCG -> TCAACAACGTCCAACGCGC
ATAGAGATGGGTCAAACAA -> TAGAGATGGGTCAAACAAG
GTTGTTATAGTCCTGGCAC -> TTGTTATAGTCCTGGCACT
CATGCTGCCCTCCACCAGT -> ATGCTGCCCTCCACCAGTC
TGCGTTGTTATAGTCCTGG -> GCGTTGTTATAGTCCTGGC
CGACGAAAGCGTCTGCGAT -> GACGAAAGCGTCTGCGATT
GCACACTGTCATTATATGC -> CACACTGTCATTATATGCC
CGATGGACGCCATCTCATA -> GATGGACGCCATCTCATAA
GCCCTTCAGTGGGCGCAAG -> CCCTTCAGTGGGCGCAAGG
CGACGATGGTTTGGTCACA -> GACGATGGTTTGGTCACAA
GTTGCGATCAAAGAGATGG -> TTGCGATCAAAGAGATGGT
GATGACTTGTCGGGTATAC -> ATGACTTGTCGGGTATACG
TTCCTGTAGCCCTCAACAA -> TCCTGTAGCCCTCAACAAC
TGTCTCGTCCGTGTAATCC -> GTCTCGTCCGTGTAATCCC
GAGGCGTCAGTAATTCATT -> AGGCGTCAGTAATTCATTC
CCCGTTTTTGAGGGCATAG -> CCGTTTTTGAGGGCATAGC
CATGCCTCGAGCAAAGATG -> ATGCCTCGAGCAAAGATGA
TCAGTGGGGAATTTCGCCC -> CAGTGGGGAATTTCGCCCT
TACCACACGTTCGCATATT -> ACCACACGTTCGCATATTC
TCGTGAACTCATTCGCGGC -> CGTGAACTCATTCGCGGCA
TGTGATTGAATATAGAGAT -> GTGATTGAATATAGAGATG
CCGAGTCAAGTAGGCGACG -> CGAGTCAAGTAGGCGACGA
GTCTCCCTCTGTCGTGAAC -> TCTCCCTCTGTCGTGAACT
TACTCAATGGAGGCGTCAG -> ACTCAATGGAGGCGTCAGT
GCGGGACCGAATTTCGCCC -> CGGGACCGAATTTCGCCCT
TACGGTCTCTTGGCGACTA -> ACGGTCTCTTGGCGACTAT
GACGCGAGAGCGAATCAAC -> ACGCGAGAGCGAATCAACC
TCATGTGCAACTCTATTCG -> CATGTGCAACTCTATTCGC
GACTATGTGTGATTGAATA -> ACTATGTGTGATTGAATAT
TGGTTCACCTTGCGCGCGT -> GGTTCACCTTGCGCGCGTA
CAGGGTCAAGAGACACCGC -> AGGGTCAAGAGACACCGCG
GCCGATACAGCTCCACATG -> CCGATACAGCTCCACATGC
ATATGCTATTCCGCAGTGG -> TATGCTATTCCGCAGTGGC
TGCATCTCCAAGTCATGGG -> GCATCTCCAAGTCATGGGT
CAAGTAGATACCGATAGTG -> AAGTAGATACCGATAGTGT
GCCGGAGAGACATGATCGC -> CCGGAGAGACATGATCGCC
CATGATCGCCGCGACGCGG -> ATGATCGCCGCGACGCGGA
AGTCAGTTACCAGACCAGG -> GTCAGTTACCAGACCAGGG
GACAAATGCTTAGAACAAA -> ACAAATGCTTAGAACAAAT
ACTTGTCGGGTATACGTGC -> CTTGTCGGGTATACGTGCA
CGCATATTCAAGTACGGGA -> GCATATTCAAGTACGGGAC
ACTGTGCTCCTTTTTTTGT -> CTGTGCTCCTTTTTTTGTT
TACGATCTGTGTCAACGTG -> ACGATCTGTGTCAACGTGC
TTCGCCCTTCAGTGGCATG -> TCGCCCTTCAGTGGCATGC
GCGCTCTCAGGGGTCGTTG -> CGCTCTCAGGGGTCGTTGG
ATTCCTGTAGCCCTCAACA -> TTCCTGTAGCCCTCAACAA
TCACCCAATATTGCGATTT -> CACCCAATATTGCGATTTT
CTTCCTGGATGACTTGTCG -> TTCCTGGATGACTTGTCGG
TGTATGAGCACCCTAGCCC -> GTATGAGCACCCTAGCCCC
CCAGAATCGACGCTGGAAC -> CAGAATCGACGCTGGAACA
TAGGGAATTTCGCCCTTCA -> AGGGAATTTCGCCCTTCAG
CCCTTCCTGGATGACTTGT -> CCTTCCTGGATGACTTGTC
CATAACTACGGTCTCTTGG -> ATAACTACGGTCTCTTGGC
AGAGACACCGCGGCGCATA -> GAGACACCGCGGCGCATAC
GCCTGCACAGGGCTTCTCG -> CCTGCACAGGGCTTCTCGA
GCAGACTTTGCATGCATAC -> CAGACTTTGCATGCATACA
GGTCTCTTGGCGACTATGT -> GTCTCTTGGCGACTATGTG
CTCCTTTTTTTGTTGTCTC -> TCCTTTTTTTGTTGTCTCG
AGCTCAATGACCCGTTTTT -> GCTCAATGACCCGTTTTTG
AAGCCTGAAGTCTCCCTCT -> AGCCTGAAGTCTCCCTCTG
AAGTCCGCTTACTCGTCCG -> AGTCCGCTTACTCGTCCGA
GCTGCGTGGCTGACGGTCA -> CTGCGTGGCTGACGGTCAA
AATCCGACGCCTAGAGCTC -> ATCCGACGCCTAGAGCTCT
TCGCCCTTCAGTGGGGAAT -> CGCCCTTCAGTGGGGAATT
TTTGAACGACATGCCTCGA -> TTGAACGACATGCCTCGAG
CGCAAGTAGATACCGATAG -> GCAAGTAGATACCGATAGT
CCCTCTGTCGTGAACTCAT -> CCTCTGTCGTGAACTCATT
ACAAGTACCCCGTCACCCT -> CAAGTACCCCGTCACCCTT
AATGCTAAATAAACATGCA -> ATGCTAAATAAACATGCAT
AAGACAAGCACACTGTCAT -> AGACAAGCACACTGTCATT
GTGGTTACGTCCTCCTCGG -> TGGTTACGTCCTCCTCGGT
TAGAAACCACATTGCATCT -> AGAAACCACATTGCATCTC
GTACGGGTGTACGCACTTT -> TACGGGTGTACGCACTTTT
CGGCCTTAGAATAGAGCTC -> GGCCTTAGAATAGAGCTCC
TCCTGTCTCGTTTCTGTAT -> CCTGTCTCGTTTCTGTATG
CCGTTTTTGAGGGCATAGC -> CGTTTTTGAGGGCATAGCT
CATTGCATCTCCAAGTCAT -> ATTGCATCTCCAAGTCATG
TTCATCAATGCACACGCCG -> TCATCAATGCACACGCCGT
AGTTGCAGGAGCAACCCTA -> GTTGCAGGAGCAACCCTAG
CAAGTCATGGGTAAGCCTG -> AAGTCATGGGTAAGCCTGA
AGAGCCGAGTTACCAGAAT -> GAGCCGAGTTACCAGAATC
GGAGAGACATGATCGCCGC -> GAGAGACATGATCGCCGCG
CTGGGCAATCGGTTTCTAG -> TGGGCAATCGGTTTCTAGC
CTACATAAAGTCAGTTACC -> TACATAAAGTCAGTTACCA
GCCATTTTCGGAGATTCTT -> CCATTTTCGGAGATTCTTG
ATAAATGTTTGGTCGGCAC -> TAAATGTTTGGTCGGCACT
GAGCAAAGATGAGCCACGT -> AGCAAAGATGAGCCACGTA
AGTTACCAGACCAGGGCGG -> GTTACCAGACCAGGGCGGT
CTTCAGTGGGCGCAAGGAA -> TTCAGTGGGCGCAAGGAAA
GTCTGGGAAGTTAGGGAAT -> TCTGGGAAGTTAGGGAATT
GTGGTGCCGCAAGTAGATA -> TGGTGCCGCAAGTAGATAC
AGAATAGAGCTCCATCACC -> GAATAGAGCTCCATCACCA
TCTCTTGGCGACTATGTGT -> CTCTTGGCGACTATGTGTG
TCAGTGGTGCCGCAAGTAG -> CAGTGGTGCCGCAAGTAGA
TCACCTTGCGCGCGTAGTA -> CACCTTGCGCGCGTAGTAT
CGGGACCGAATTTCGCCCT -> GGGACCGAATTTCGCCCTT
TTTAAGGGTAAATTACTAT -> TTAAGGGTAAATTACTATT
CCACCCCTGCTGGGAGTAT -> CACCCCTGCTGGGAGTATG
CGCGTATGGGGCAGGACAA -> GCGTATGGGGCAGGACAAA
GTCTCGTTTCTGTATGAGC -> TCTCGTTTCTGTATGAGCA
ACCTGGGATGTACAATAGG -> CCTGGGATGTACAATAGGT
TCGAGCAAAGATGAGCCAC -> CGAGCAAAGATGAGCCACG
CTCATGAAAGACAAGCACA -> TCATGAAAGACAAGCACAC
TCAAGCAGAGTGGAATTTC -> CAAGCAGAGTGGAATTTCG
TCTCGCCCGCGTATGGGGC -> CTCGCCCGCGTATGGGGCA
GGTAAAGTCGAGTTCGCAG -> GTAAAGTCGAGTTCGCAGA
ATAGGTTAGTTGCAGGAGC -> TAGGTTAGTTGCAGGAGCA
AGCGAATCAACCACAGTTC -> GCGAATCAACCACAGTTCA
GCCCACAGTCCTGTCTCGT -> CCCACAGTCCTGTCTCGTT
TGGTTAGGCAGAAATGTCG -> GGTTAGGCAGAAATGTCGA
AGCCCTCAACAACGTCCAA -> GCCCTCAACAACGTCCAAC
TAGCGGTCACCCAATATTG -> AGCGGTCACCCAATATTGC
ATCAGTTTGGCCCTCCGAT -> TCAGTTTGGCCCTCCGATT
GGTAACCACCATTAAAGTC -> GTAACCACCATTAAAGTCC
GTGGTAAGCCCACAGTCCT -> TGGTAAGCCCACAGTCCTG
TTGAATATAGAGATGGGTC -> TGAATATAGAGATGGGTCA
ACAGTCCTGTCTCGTTTCT -> CAGTCCTGTCTCGTTTCTG
GGGGCAGGACAAATGCTTA -> GGGCAGGACAAATGCTTAG
ATTAAGAGCACTCAAACGT -> TTAAGAGCACTCAAACGTC
AAGGAAACCAAACAGCCCG -> AGGAAACCAAACAGCCCGA
CCTGGCACTTAGCGAAAGA -> CTGGCACTTAGCGAAAGAA
AATAAGACGCAATGCTAAA -> ATAAGACGCAATGCTAAAT
CTGGAACAAATGGAGTTGT -> TGGAACAAATGGAGTTGTC
GTATGTCCTCTGCAATGAG -> TATGTCCTCTGCAATGAGC
TACCAGACCAGGGCGGTAC -> ACCAGACCAGGGCGGTACG
GCTTCTGCGACGATGGTTT -> CTTCTGCGACGATGGTTTG
GGGTGTACGCACTTTTCGC -> GGTGTACGCACTTTTCGCT
GCTCCCGCCCTACGATCTG -> CTCCCGCCCTACGATCTGT
TCGTTTCTGTATGAGCACC -> CGTTTCTGTATGAGCACCC
TGAACTCATTCGCGGCACA -> GAACTCATTCGCGGCACAC
CTCCCTCTGTCGTGAACTC -> TCCCTCTGTCGTGAACTCA
CGGGTAAAGTCGAGTTCGC -> GGGTAAAGTCGAGTTCGCA
GGCGGTACGGGTGTACGCA -> GCGGTACGGGTGTACGCAC
ACCGAATTTCGCCCTTCAG -> CCGAATTTCGCCCTTCAGT
CCTGGGATGTACAATAGGT -> CTGGGATGTACAATAGGTT
CAAGTAACGGGGCAGCACC -> AAGTAACGGGGCAGCACCT
ATCGCCGCGACGCGGAGGC -> TCGCCGCGACGCGGAGGCA
CTGTATGAGCACCCTAGCC -> TGTATGAGCACCCTAGCCC
CGTTTCTGTATGAGCACCC -> GTTTCTGTATGAGCACCCT
CAATGACCCGTTTTTGAGG -> AATGACCCGTTTTTGAGGG
GGTGAACAACTACAACAGT -> GTGAACAACTACAACAGTT
GTCCGACGGACACGAACAA -> TCCGACGGACACGAACAAA
ACTACAACAGTTCATCAAT -> CTACAACAGTTCATCAATG
TGGTCACAAGTTAGCACAC -> GGTCACAAGTTAGCACACA
TATATGCCCTGCCGGAGAG -> ATATGCCCTGCCGGAGAGA
TGTCTCGTTTCTGTATGAG -> GTCTCGTTTCTGTATGAGC
TGCGATTAAAGCTGTGGTT -> GCGATTAAAGCTGTGGTTG
GAACAGAGCCGAGTTACCA -> AACAGAGCCGAGTTACCAG
CTATTCGCAGATAGCCAAA -> TATTCGCAGATAGCCAAAT
TAAATAAACATGCATATGC -> AAATAAACATGCATATGCT
TGCAGGAGCAACCCTAGCG -> GCAGGAGCAACCCTAGCGT
TGCGGAATTAAGTAGATAT -> GCGGAATTAAGTAGATATG
AGTGGCATGCAAGGCTTGA -> GTGGCATGCAAGGCTTGAA
CGTTGGTTAGGCAGAAATG -> GTTGGTTAGGCAGAAATGT
TAGTTCATTAAGTAAATTC -> AGTTCATTAAGTAAATTCC
CTGGTATTGACTAGACGGG -> TGGTATTGACTAGACGGGT
TTCGCTGCGTGGCTGACGG -> TCGCTGCGTGGCTGACGGT
GTCACCCAATATTGCGATT -> TCACCCAATATTGCGATTT
TGTATAGTACAGGATTAAT -> GTATAGTACAGGATTAATG
TATAGAGATGGGTCAAACA -> ATAGAGATGGGTCAAACAA
ATGGAGGCGTCAGTAATTC -> TGGAGGCGTCAGTAATTCA
TGTGTGATTGAATATAGAG -> GTGTGATTGAATATAGAGA
CTCTATTCGCAGATAGCCA -> TCTATTCGCAGATAGCCAA
CAGCCACAACTCGCGCTAT -> AGCCACAACTCGCGCTATG
GCGGCACACTACATGGATG -> CGGCACACTACATGGATGG
TTGGTTAGGCAGAAATGTC -> TGGTTAGGCAGAAATGTCG
AGGACAAATGCTTAGAACA -> GGACAAATGCTTAGAACAA
AAGTAGGCGACGAAAGCGT -> AGTAGGCGACGAAAGCGTC
CCTCCTCGGTGTAATTGAC -> CTCCTCGGTGTAATTGACT
TTCATTCCTGTAGCCCTCA -> TCATTCCTGTAGCCCTCAA
TCGACGACCCTTGCCGATA -> CGACGACCCTTGCCGATAC
TGAATATAGAGATGGGTCA -> GAATATAGAGATGGGTCAA
GAGCACTCAAACGTCAAGC -> AGCACTCAAACGTCAAGCA
GTCACAAGTTAGCACACAC -> TCACAAGTTAGCACACACG
CAACTGTGCTCCTTTTTTT -> AACTGTGCTCCTTTTTTTG
CCAAGCTTGTATGTGGTAA -> CAAGCTTGTATGTGGTAAC
GCCATCTCATAACTACGGT -> CCATCTCATAACTACGGTC
GCCCTCAACAACGTCCAAC -> CCCTCAACAACGTCCAACG
CCCCCAAGCTTGTATGTGG -> CCCCAAGCTTGTATGTGGT
AGTACGCCTGCACAGGGCT -> GTACGCCTGCACAGGGCTT
CAAACAAGATTAAGAGCAC -> AAACAAGATTAAGAGCACT
CCTTTTTTTGTTGTCTCGT -> CTTTTTTTGTTGTCTCGTC
GGGACCGAATTTCGCCCTT -> GGACCGAATTTCGCCCTTC
CGGCTAGAAACCACATTGC -> GGCTAGAAACCACATTGCA
GACACGAACAAATGGAGTT -> ACACGAACAAATGGAGTTG
AGCGCTTATCGCGGGTGTC -> GCGCTTATCGCGGGTGTCA
TAAACATGCATATGCTATT -> AAACATGCATATGCTATTC
GTCCTCTGCAATGAGCAAA -> TCCTCTGCAATGAGCAAAT
CACTTGGTAGTACGCCTGC -> ACTTGGTAGTACGCCTGCA
TATTGACTAGACGGGTAAA -> ATTGACTAGACGGGTAAAG
TACGTTGTATAGTACAGGA -> ACGTTGTATAGTACAGGAT
CACCTTGCGCGCGTAGTAT -> ACCTTGCGCGCGTAGTATA
AGCTGTGGTTGAGTGGCCC -> GCTGTGGTTGAGTGGCCCC
GCAAGGCTTGAAGCATGCT -> CAAGGCTTGAAGCATGCTG
CCGATACAGCTCCACATGC -> CGATACAGCTCCACATGCG
GCAGGAGCAACCCTAGCGT -> CAGGAGCAACCCTAGCGTC
TGGATGGGTCAGGATTGAA -> GGATGGGTCAGGATTGAAA
GGAGATTCTTGCGGAATTA -> GAGATTCTTGCGGAATTAA
GAACAACTACAACAGTTCA -> AACAACTACAACAGTTCAT
CTTAACCCGATCAGTTTGG -> TTAACCCGATCAGTTTGGC
CTGCGACGATGGTTTGGTC -> TGCGACGATGGTTTGGTCA
TGCTAAATAAACATGCATA -> GCTAAATAAACATGCATAT
TTGACTTAACCCGATCAGT -> TGACTTAACCCGATCAGTT
AAATAAGACGCAATGCTAA -> AATAAGACGCAATGCTAAA
ATGCCCTGCCGGAGAGACA -> TGCCCTGCCGGAGAGACAT
GGCACACTACATGGATGGG -> GCACACTACATGGATGGGT
CCCCGTCACCCTTCCTGGA -> CCCGTCACCCTTCCTGGAT
GGCAGAAATGTCGACGACC -> GCAGAAATGTCGACGACCC
TTTCGCCCTTCAGTGGGGA -> TTCGCCCTTCAGTGGGGAA
AAGTTAGCACACACGTGGT -> AGTTAGCACACACGTGGTT
CTGCGTTGATAGCGCTTAT -> TGCGTTGATAGCGCTTATC
GCGAATCAACCACAGTTCA -> CGAATCAACCACAGTTCAA
GAACAAATGGAGTTGTCTA -> AACAAATGGAGTTGTCTAA
CATCTCCAAGTCATGGGTA -> ATCTCCAAGTCATGGGTAA
GGTAAGCCCACAGTCCTGT -> GTAAGCCCACAGTCCTGTC
GCATGCATACATTTAAGGG -> CATGCATACATTTAAGGGT
CGATCAGTTTGGCCCTCCG -> GATCAGTTTGGCCCTCCGA
CATAGCTCAGTCATAGTTC -> ATAGCTCAGTCATAGTTCA
CCACATGCGTTCCAAAGAC -> CACATGCGTTCCAAAGACC
TTGCGGAATTAAGTAGATA -> TGCGGAATTAAGTAGATAT
TGTTATAGTCCTGGCACTT -> GTTATAGTCCTGGCACTTA
ACCACCGGCCTTAGAATAG -> CCACCGGCCTTAGAATAGA
TTGCGCTCATGTGCAACTC -> TGCGCTCATGTGCAACTCT
TTTTCGGAGATTCTTGCGG -> TTTCGGAGATTCTTGCGGA
AACAAATGGAGTTGTCTAA -> ACAAATGGAGTTGTCTAAC
CACCTGCGTTGATAGCGCT -> ACCTGCGTTGATAGCGCTT
GCCACAACTCGCGCTATGG -> CCACAACTCGCGCTATGGC
TAGTGTAGCGGTCACCCAA -> AGTGTAGCGGTCACCCAAT
ATTATATGCCCTGCCGGAG -> TTATATGCCCTGCCGGAGA
AGGCAGAAATGTCGACGAC -> GGCAGAAATGTCGACGACC
TACCCCGTCACCCTTCCTG -> ACCCCGTCACCCTTCCTGG
CAGGATTAATGGCGCTCTC -> AGGATTAATGGCGCTCTCA
ATAGCCAAATCCGACGCCT -> TAGCCAAATCCGACGCCTA
ACTATTTGGCACTCACGGA -> CTATTTGGCACTCACGGAC
TTCGCAGACTTTGCATGCA -> TCGCAGACTTTGCATGCAT
CCTAGCGTCCGATAAATAA -> CTAGCGTCCGATAAATAAG
CCTGGATGACTTGTCGGGT -> CTGGATGACTTGTCGGGTA
TTTTTTTGTTGTCTCGTCC -> TTTTTTGTTGTCTCGTCCG
TGGAACAAATGGAGTTGTC -> GGAACAAATGGAGTTGTCT
GCAAGTAGATACCGATAGT -> CAAGTAGATACCGATAGTG
CTCGCGCTATGGCAAGTAA -> TCGCGCTATGGCAAGTAAC
ACCGATAGTGTAGCGGTCA -> CCGATAGTGTAGCGGTCAC
TCAGTTACCAGACCAGGGC -> CAGTTACCAGACCAGGGCG
GTATACGTGCAGCCGCCCG -> TATACGTGCAGCCGCCCGA
ACGAAAGTAGACTTTTTGA -> CGAAAGTAGACTTTTTGAA
GGAGTTGTCTTACGCGGGA -> GAGTTGTCTTACGCGGGAC
TACAGCTCCACATGCGTTC -> ACAGCTCCACATGCGTTCC
ACCCCTGCTGGGAGTATGT -> CCCCTGCTGGGAGTATGTC
GCCTAGAGCTCTGACCACC -> CCTAGAGCTCTGACCACCG
TAGGTTAGTTGCAGGAGCA -> AGGTTAGTTGCAGGAGCAA
CGGAGGCAGAAGTTGCGCA -> GGAGGCAGAAGTTGCGCAT
TGCGCTCATGTGCAACTCT -> GCGCTCATGTGCAACTCTA
CTCAATGACCCGTTTTTGA -> TCAATGACCCGTTTTTGAG
GTCCGACGGCTTCTGCGAC -> TCCGACGGCTTCTGCGACG
TCTACAGGGTCAAGAGACA -> CTACAGGGTCAAGAGACAC
TTCGCAGATAGCCAAATCC -> TCGCAGATAGCCAAATCCG
GGTAAGCCTGAAGTCTCCC -> GTAAGCCTGAAGTCTCCCT
AAATGTCGACGACCCTTGC -> AATGTCGACGACCCTTGCC
TCTGCACGATCGACATTCT -> CTGCACGATCGACATTCTA
CGTCCAACGCGCAGATCAG -> GTCCAACGCGCAGATCAGC
GTAGGCGACGAAAGCGTCT -> TAGGCGACGAAAGCGTCTG
GGTTGAGTGGCCCCTCCCA -> GTTGAGTGGCCCCTCCCAC
TGGCACTCACGGACCCCCG -> GGCACTCACGGACCCCCGC
ACAGCCCGAGCGGTTGCGA -> CAGCCCGAGCGGTTGCGAT
TTCCTGGATGACTTGTCGG -> TCCTGGATGACTTGTCGGG
CAAGATTAAGAGCACTCAA -> AAGATTAAGAGCACTCAAA
TACGTGCAGCCGCCCGAGT -> ACGTGCAGCCGCCCGAGTC
ACGATGGTTTGGTCACAAG -> CGATGGTTTGGTCACAAGT
GGCCTTAGAATAGAGCTCC -> GCCTTAGAATAGAGCTCCA
TTCCAGCCATTTTCGGAGA -> TCCAGCCATTTTCGGAGAT
CTTAGAATAGAGCTCCATC -> TTAGAATAGAGCTCCATCA
GATACAGCTCCACATGCGT -> ATACAGCTCCACATGCGTT
CACACGCCGTTGTCTCGCC -> ACACGCCGTTGTCTCGCCC
GCAAAGATGAGCCACGTAT -> CAAAGATGAGCCACGTATT
AAGAGATGGTTCACCTTGC -> AGAGATGGTTCACCTTGCG
ACATTCTACATAAAGTCAG -> CATTCTACATAAAGTCAGT
AGGAGCAACCCTAGCGTCC -> GGAGCAACCCTAGCGTCCG
CCTGCTGGGAGTATGTCCT -> CTGCTGGGAGTATGTCCTC
AGTTAGGGAATTTCGCCCT -> GTTAGGGAATTTCGCCCTT
ATCGACGCTGGAACAAATG -> TCGACGCTGGAACAAATGG
GCAGGACAAATGCTTAGAA -> CAGGACAAATGCTTAGAAC
TCGCGGGTGTCACTTGGTA -> CGCGGGTGTCACTTGGTAG
CGAATCAACCACAGTTCAA -> GAATCAACCACAGTTCAAG
GTTGTCTTACGCGGGACCG -> TTGTCTTACGCGGGACCGA
CAGAATCGACGCTGGAACA -> AGAATCGACGCTGGAACAA
TCAAAGAGATGGTTCACCT -> CAAAGAGATGGTTCACCTT
GACCCGTTTTTGAGGGCAT -> ACCCGTTTTTGAGGGCATA
TCCTCCTCGGTGTAATTGA -> CCTCCTCGGTGTAATTGAC
ATGTGCAACTCTATTCGCA -> TGTGCAACTCTATTCGCAG
AAATCGGCTCCCGCCCTAC -> AATCGGCTCCCGCCCTACG
TGTTTGGTCGGCACTAAGC -> GTTTGGTCGGCACTAAGCT
TGCGTTCCAAAGACCTGGG -> GCGTTCCAAAGACCTGGGA
ACAAGTTAGCACACACGTG -> CAAGTTAGCACACACGTGG
AGTCGAGTTCGCAGACTTT -> GTCGAGTTCGCAGACTTTG
TGCCGATACAGCTCCACAT -> GCCGATACAGCTCCACATG
GGGTCAAACAAGATTAAGA -> GGTCAAACAAGATTAAGAG
TCCGCTTACTCGTCCGACG -> CCGCTTACTCGTCCGACGG
GTGAACAAATGGAGTTGTC -> TGAACAAATGGAGTTGTCT
CTAGAGCTCTGACCACCGG -> TAGAGCTCTGACCACCGGC
TTGAGTGGCCCCTCCCACC -> TGAGTGGCCCCTCCCACCC
TTCGCCCTTCAGTGGTGCC -> TCGCCCTTCAGTGGTGCCG
GTACGCACTTTTCGCTGCG -> TACGCACTTTTCGCTGCGT
AGAGCTCCATCACCAACAA -> GAGCTCCATCACCAACAAG
GGACAAATGCTTAGAACAA -> GACAAATGCTTAGAACAAA
AGAGCACTCAAACGTCAAG -> GAGCACTCAAACGTCAAGC
GCAACTCTATTCGCAGATA -> CAACTCTATTCGCAGATAG
GGACACGAACAAATGGAGT -> GACACGAACAAATGGAGTT
CATTCTACATAAAGTCAGT -> ATTCTACATAAAGTCAGTT
ACGCTGGAACAAATGGAGT -> CGCTGGAACAAATGGAGTT
CTAGCGTCCGATAAATAAG -> TAGCGTCCGATAAATAAGA
ACCAGAATCGACGCTGGAA -> CCAGAATCGACGCTGGAAC
TGCGACGATGGTTTGGTCA -> GCGACGATGGTTTGGTCAC
TTATAGTCCTGGCACTTAG -> TATAGTCCTGGCACTTAGC
AACGGAGGAGCTCAATGAC -> ACGGAGGAGCTCAATGACC
TCGCCCGCGTATGGGGCAG -> CGCCCGCGTATGGGGCAGG
TGGAGTGAACAAATGGAGT -> GGAGTGAACAAATGGAGTT
TAGACGGGTAAAGTCGAGT -> AGACGGGTAAAGTCGAGTT
GTCATAGTTCATTAAGTAA -> TCATAGTTCATTAAGTAAA
ATTTCGCCCTTCAGTGGCA -> TTTCGCCCTTCAGTGGCAT
TTTCGCCCTTCAGTGGCAT -> TTCGCCCTTCAGTGGCATG
GCGTCAGTAATTCATTCCT -> CGTCAGTAATTCATTCCTG
TTACGTCCTCCTCGGTGTA -> TACGTCCTCCTCGGTGTAA
TAACGGGGCAGCACCTGCG -> AACGGGGCAGCACCTGCGT
CGCATACAGTGGTAAGCCC -> GCATACAGTGGTAAGCCCA
GATTCTTGCGGAATTAAGT -> ATTCTTGCGGAATTAAGTA
TGTATGTGGTAACCACCAT -> GTATGTGGTAACCACCATT
TTACGCGGGACCGAATTTC -> TACGCGGGACCGAATTTCG
CCGCGTATGGGGCAGGACA -> CGCGTATGGGGCAGGACAA
GCTCCACATGCGTTCCAAA -> CTCCACATGCGTTCCAAAG
ACGCCATCTCATAACTACG -> CGCCATCTCATAACTACGG
TCGGCACTAAGCTGGTATT -> CGGCACTAAGCTGGTATTG
TCGCCCTTCAGTGGCATGC -> CGCCCTTCAGTGGCATGCA
CGCCCTACGATCTGTGTCA -> GCCCTACGATCTGTGTCAA
AGAAGTTGCGCATGCTTGC -> GAAGTTGCGCATGCTTGCG
CGCTATGGCAAGTAACGGG -> GCTATGGCAAGTAACGGGG
AGTGGGCGCAAGGAAACCA -> GTGGGCGCAAGGAAACCAA
TCTGTATGAGCACCCTAGC -> CTGTATGAGCACCCTAGCC
CAATGGAGGCGTCAGTAAT -> AATGGAGGCGTCAGTAATT
GAGGCAGAAGTTGCGCATG -> AGGCAGAAGTTGCGCATGC
ATGCTAAATAAACATGCAT -> TGCTAAATAAACATGCATA
TGAACAAATGGAGTTGTCT -> GAACAAATGGAGTTGTCTT
TTGGCGACTATGTGTGATT -> TGGCGACTATGTGTGATTG
CGGTCACCCAATATTGCGA -> GGTCACCCAATATTGCGAT
GAGATGGGTCAAACAAGAT -> AGATGGGTCAAACAAGATT
ACGTGCAGCCGCCCGAGTC -> CGTGCAGCCGCCCGAGTCA
ACTATGTGTGATTGAATAT -> CTATGTGTGATTGAATATA
GCTGCCCTCCACCAGTCCT -> CTGCCCTCCACCAGTCCTC
TTAGTCAGTTCGGTACCAC -> TAGTCAGTTCGGTACCACA
GTTGGAGTGAACAAATGGA -> TTGGAGTGAACAAATGGAG
AAGTACCCCGTCACCCTTC -> AGTACCCCGTCACCCTTCC
CGATCTACAGGGTCAAGAG -> GATCTACAGGGTCAAGAGA
ATTCTGCACGATCGACATT -> TTCTGCACGATCGACATTC
AAACCACATTGCATCTCCA -> AACCACATTGCATCTCCAA
AAAGATGAGCCACGTATTC -> AAGATGAGCCACGTATTCA
CGCCCGAGTCAAGTAGGCG -> GCCCGAGTCAAGTAGGCGA
GTGAACAACTACAACAGTT -> TGAACAACTACAACAGTTC
TAGAATAGAGCTCCATCAC -> AGAATAGAGCTCCATCACC
ATTTTCGGAGATTCTTGCG -> TTTTCGGAGATTCTTGCGG
CATCACCAACAAGTACCCC -> ATCACCAACAAGTACCCCG
GTAACCACCATTAAAGTCC -> TAACCACCATTAAAGTCCG
CCTCGAGCAAAGATGAGCC -> CTCGAGCAAAGATGAGCCA
ACCCCGTCACCCTTCCTGG -> CCCCGTCACCCTTCCTGGA
ACCCAATATTGCGATTTTT -> CCCAATATTGCGATTTTTA
TGACGGTCAACAACTGTGC -> GACGGTCAACAACTGTGCT
AAGCTTGTATGTGGTAACC -> AGCTTGTATGTGGTAACCA
CCTCCACCAGTCCTCATGA -> CTCCACCAGTCCTCATGAA
GCGCTTATCGCGGGTGTCA -> CGCTTATCGCGGGTGTCAC
TCATAGTTCATTAAGTAAA -> CATAGTTCATTAAGTAAAT
TATGCCCTGCCGGAGAGAC -> ATGCCCTGCCGGAGAGACA
TGCGTTGATAGCGCTTATC -> GCGTTGATAGCGCTTATCG
TTGACTAGACGGGTAAAGT -> TGACTAGACGGGTAAAGTC
GGCGACGAAAGCGTCTGCG -> GCGACGAAAGCGTCTGCGA
CAGATCAGCCACAACTCGC -> AGATCAGCCACAACTCGCG
CCGGCCTTAGAATAGAGCT -> CGGCCTTAGAATAGAGCTC
ACAGGGCTTCTCGATCTAC -> CAGGGCTTCTCGATCTACA
CGCGACGCGGAGGCAGAAG -> GCGACGCGGAGGCAGAAGT
ACTTTGCATGCATACATTT -> CTTTGCATGCATACATTTA
GCAGCACCTGCGTTGATAG -> CAGCACCTGCGTTGATAGC
CCAAATCCGACGCCTAGAG -> CAAATCCGACGCCTAGAGC
TTTTGTTGTCTCGTCCGTG -> TTTGTTGTCTCGTCCGTGT
AACGTCCAACGCGCAGATC -> ACGTCCAACGCGCAGATCA
TGACTTAACCCGATCAGTT -> GACTTAACCCGATCAGTTT
TATGTGTGATTGAATATAG -> ATGTGTGATTGAATATAGA
AGAAATCGGCTCCCGCCCT -> GAAATCGGCTCCCGCCCTA
ACGATCGACATTCTACATA -> CGATCGACATTCTACATAA
GTAATCCCACAGTCCGACG -> TAATCCCACAGTCCGACGG
CTGCGTGGCTGACGGTCAA -> TGCGTGGCTGACGGTCAAC
GGTGCCGCAAGTAGATACC -> GTGCCGCAAGTAGATACCG
TAGCCTAGGAAAAGGTTAT -> AGCCTAGGAAAAGGTTATA
GACCCTTGCCGATACAGCT -> ACCCTTGCCGATACAGCTC
CTATTTGGCACTCACGGAC -> TATTTGGCACTCACGGACC
TCCGATAAATAAGACGCAA -> CCGATAAATAAGACGCAAT
AAAGGTTATACGTTGTATA -> AAGGTTATACGTTGTATAG
TCAGTTTGGCCCTCCGATT -> CAGTTTGGCCCTCCGATTT
AGTTGTCTGGGAAGTTAGG -> GTTGTCTGGGAAGTTAGGG
ATTACTATTTGGCACTCAC -> TTACTATTTGGCACTCACG
AGATGGGTCAAACAAGATT -> GATGGGTCAAACAAGATTA
AAGAAATCGGCTCCCGCCC -> AGAAATCGGCTCCCGCCCT
AGGCTTGAAGCATGCTGCC -> GGCTTGAAGCATGCTGCCC
ATCTGGGCAATCGGTTTCT -> TCTGGGCAATCGGTTTCTA
TATACGTTGTATAGTACAG -> ATACGTTGTATAGTACAGG
CCCGAGCGGTTGCGATCAA -> CCGAGCGGTTGCGATCAAA
AGTCATAGTTCATTAAGTA -> GTCATAGTTCATTAAGTAA
TTCGCCCTTCAGTGGGGAA -> TCGCCCTTCAGTGGGGAAT
CGTCCGTGTAATCCCACAG -> GTCCGTGTAATCCCACAGT
GATTAAGAGCACTCAAACG -> ATTAAGAGCACTCAAACGT
TGATTGAATATAGAGATGG -> GATTGAATATAGAGATGGG
GAACAAATGGAGTTGTCTG -> AACAAATGGAGTTGTCTGG
ATAGCTCAGTCATAGTTCA -> TAGCTCAGTCATAGTTCAT
CACAAGTTAGCACACACGT -> ACAAGTTAGCACACACGTG
ACTCACGGACCCCCGCACG -> CTCACGGACCCCCGCACGA
TGGAGTTGTCTCAAGCAGA -> GGAGTTGTCTCAAGCAGAG
CAACGTGCCCTCGGGAACG -> AACGTGCCCTCGGGAACGG
CTCGTTTCTGTATGAGCAC -> TCGTTTCTGTATGAGCACC
TCCCTCTGTCGTGAACTCA -> CCCTCTGTCGTGAACTCAT
GTGGGCGCAAGGAAACCAA -> TGGGCGCAAGGAAACCAAA
ACTTGGTAGTACGCCTGCA -> CTTGGTAGTACGCCTGCAC
GTTCATTAAGTAAATTCCA -> TTCATTAAGTAAATTCCAG
TTTGCATGCATACATTTAA -> TTGCATGCATACATTTAAG
TTACTATTTGGCACTCACG -> TACTATTTGGCACTCACGG
AAGTAGATATGGGCAGCCA -> AGTAGATATGGGCAGCCAC
AATATTGCGATTTTTAGTC -> ATATTGCGATTTTTAGTCA
AAGTAAATTCCAGCCATTT -> AGTAAATTCCAGCCATTTT
CCCGCACGACGCGAGAGCG -> CCGCACGACGCGAGAGCGA
GGGTAAGCCTGAAGTCTCC -> GGTAAGCCTGAAGTCTCCC
ATTCCGCAGTGGCCGAACA -> TTCCGCAGTGGCCGAACAG
CAAAGACCTGGGATGTACA -> AAAGACCTGGGATGTACAA
TACTCGTCCGACGGCTTCT -> ACTCGTCCGACGGCTTCTG
TCCTCAATAAATGTTTGGT -> CCTCAATAAATGTTTGGTC
TCCTGTAGCCCTCAACAAC -> CCTGTAGCCCTCAACAACG
ACAGGATTAATGGCGCTCT -> CAGGATTAATGGCGCTCTC
GCGATTAAAGCTGTGGTTG -> CGATTAAAGCTGTGGTTGA
CAGCCATTTTCGGAGATTC -> AGCCATTTTCGGAGATTCT
TGTCTGGGAAGTTAGGGAA -> GTCTGGGAAGTTAGGGAAT
ACAAATGGAGTTGTCTCAA -> CAAATGGAGTTGTCTCAAG
CAGGGGTCGTTGGTTAGGC -> AGGGGTCGTTGGTTAGGCA
GCACCCTAGCCCCCAAGCT -> CACCCTAGCCCCCAAGCTT
AGCACTCAAACGTCAAGCA -> GCACTCAAACGTCAAGCAA
GTTACCAGAATCGACGCTG -> TTACCAGAATCGACGCTGG
TTCTCGATCTACAGGGTCA -> TCTCGATCTACAGGGTCAA
TGCAACTCTATTCGCAGAT -> GCAACTCTATTCGCAGATA
TCCAAGTCATGGGTAAGCC -> CCAAGTCATGGGTAAGCCT
GCGCAGATCAGCCACAACT -> CGCAGATCAGCCACAACTC
AATTTCGCCCTTCAGTGGC -> ATTTCGCCCTTCAGTGGCA
GGTTACGTCCTCCTCGGTG -> GTTACGTCCTCCTCGGTGT
ACGCGCAGATCAGCCACAA -> CGCGCAGATCAGCCACAAC
CCATTAAAGTCCGCTTACT -> CATTAAAGTCCGCTTACTC
ACTCGTCCGACGGCTTCTG -> CTCGTCCGACGGCTTCTGC
CGCCCTTCAGTGGTGCCGC -> GCCCTTCAGTGGTGCCGCA
AGAGTGGAATTTCGCCCTT -> GAGTGGAATTTCGCCCTTC
GAACAAATGGAGTTGTCTT -> AACAAATGGAGTTGTCTTA
TGCAAGGCTTGAAGCATGC -> GCAAGGCTTGAAGCATGCT
CATATTCAAGTACGGGACG -> ATATTCAAGTACGGGACGC
CACAGTCCTGTCTCGTTTC -> ACAGTCCTGTCTCGTTTCT
TACAGGATTAATGGCGCTC -> ACAGGATTAATGGCGCTCT
ACTTTTTGAACGACATGCC -> CTTTTTGAACGACATGCCT
CAGCACCTGCGTTGATAGC -> AGCACCTGCGTTGATAGCG
CCTGTAGCCCTCAACAACG -> CTGTAGCCCTCAACAACGT
ATCAACCACAGTTCAAGAG -> TCAACCACAGTTCAAGAGC
CGCGCAGATCAGCCACAAC -> GCGCAGATCAGCCACAACT
GGGAATTTCGCCCTTCAGT -> GGAATTTCGCCCTTCAGTG,GGAATTTCGCCCTTCAGTG
AGCTCCATCACCAACAAGT -> GCTCCATCACCAACAAGTA
TGCATACATTTAAGGGTAA -> GCATACATTTAAGGGTAAA
TTAAAGTCCGCTTACTCGT -> TAAAGTCCGCTTACTCGTC
CTGCACAGGGCTTCTCGAT -> TGCACAGGGCTTCTCGATC
GGAGGCAGAAGTTGCGCAT -> GAGGCAGAAGTTGCGCATG
AGGTTATACGTTGTATAGT -> GGTTATACGTTGTATAGTA
GAAATGTCGACGACCCTTG -> AAATGTCGACGACCCTTGC
CCCTCCGATTTCGGCTAGA -> CCTCCGATTTCGGCTAGAA
ACAAATGGAGTTGTCTTAC -> CAAATGGAGTTGTCTTACG
TCGATCTACAGGGTCAAGA -> CGATCTACAGGGTCAAGAG
CAGTGGGGAATTTCGCCCT -> AGTGGGGAATTTCGCCCTT
CAGACTTTGCATGCATACA -> AGACTTTGCATGCATACAT
TCTAACGTTGGAGTGAACA -> CTAACGTTGGAGTGAACAA
CGGAATTAAGTAGATATGG -> GGAATTAAGTAGATATGGG
GTCCTGGCACTTAGCGAAA -> TCCTGGCACTTAGCGAAAG
TGAGCAAATGGTGAACAAC -> GAGCAAATGGTGAACAACT
GGGCTTCTCGATCTACAGG -> GGCTTCTCGATCTACAGGG
GGGGCAGCACCTGCGTTGA -> GGGCAGCACCTGCGTTGAT
ACATGGATGGGTCAGGATT -> CATGGATGGGTCAGGATTG
GACATGATCGCCGCGACGC -> ACATGATCGCCGCGACGCG
GGTCGGCACTAAGCTGGTA -> GTCGGCACTAAGCTGGTAT
TGCGATCAAAGAGATGGTT -> GCGATCAAAGAGATGGTTC
ACAGCTCCACATGCGTTCC -> CAGCTCCACATGCGTTCCA
CCTCGGGAACGGAGGAGCT -> CTCGGGAACGGAGGAGCTC
AAATTCCAGCCATTTTCGG -> AATTCCAGCCATTTTCGGA
CTCGTCCGTGTAATCCCAC -> TCGTCCGTGTAATCCCACA
ACGAACAAATGGAGTTGTC -> CGAACAAATGGAGTTGTCT
CACTACATGGATGGGTCAG -> ACTACATGGATGGGTCAGG
CCAATATTGCGATTTTTAG -> CAATATTGCGATTTTTAGT
AATAGGTTAGTTGCAGGAG -> ATAGGTTAGTTGCAGGAGC
CCTCTGTCGTGAACTCATT -> CTCTGTCGTGAACTCATTC
GCGATCAAAGAGATGGTTC -> CGATCAAAGAGATGGTTCA
TGCACAGGGCTTCTCGATC -> GCACAGGGCTTCTCGATCT
GTTGTCTCGTCCGTGTAAT -> TTGTCTCGTCCGTGTAATC
TGGAATTTCGCCCTTCAGT -> GGAATTTCGCCCTTCAGTG
CCGTGTAATCCCACAGTCC -> CGTGTAATCCCACAGTCCG
GGAGTATGTCCTCTGCAAT -> GAGTATGTCCTCTGCAATG
CATGTGCAACTCTATTCGC -> ATGTGCAACTCTATTCGCA
GGTAAATTACTATTTGGCA -> GTAAATTACTATTTGGCAC
GAAGTCTCCCTCTGTCGTG -> AAGTCTCCCTCTGTCGTGA
ATAAAGTCAGTTACCAGAC -> TAAAGTCAGTTACCAGACC
ATGCATACATTTAAGGGTA -> TGCATACATTTAAGGGTAA
AAATTCTGCACGATCGACA -> AATTCTGCACGATCGACAT
GCCGCAAGTAGATACCGAT -> CCGCAAGTAGATACCGATA
GTCAGTTCGGTACCACACG -> TCAGTTCGGTACCACACGT
CGCCGCGACGCGGAGGCAG -> GCCGCGACGCGGAGGCAGA
ATGGAGTTGTCTTACGCGG -> TGGAGTTGTCTTACGCGGG
CACCAACAAGTACCCCGTC -> ACCAACAAGTACCCCGTCA
ACGCTCCTCAATAAATGTT -> CGCTCCTCAATAAATGTTT
GCTTACTCGTCCGACGGCT -> CTTACTCGTCCGACGGCTT
GACTTAACCCGATCAGTTT -> ACTTAACCCGATCAGTTTG
GTCCAACGCGCAGATCAGC -> TCCAACGCGCAGATCAGCC
TCTCATAACTACGGTCTCT -> CTCATAACTACGGTCTCTT
ATTTCGCCCTTCAGTGGGC -> TTTCGCCCTTCAGTGGGCG
GAGAGCGAATCAACCACAG -> AGAGCGAATCAACCACAGT
TGTAATCCCACAGTCCGAC -> GTAATCCCACAGTCCGACG
AGTAGACTTTTTGAACGAC -> GTAGACTTTTTGAACGACA
GATGGGTCAAACAAGATTA -> ATGGGTCAAACAAGATTAA
TTGTCTGGGAAGTTAGGGA -> TGTCTGGGAAGTTAGGGAA
TTTCTGTATGAGCACCCTA -> TTCTGTATGAGCACCCTAG
GTGATTGAATATAGAGATG -> TGATTGAATATAGAGATGG
TTAGGCAGAAATGTCGACG -> TAGGCAGAAATGTCGACGA
GCACAGGGCTTCTCGATCT -> CACAGGGCTTCTCGATCTA
TAAGTAGATATGGGCAGCC -> AAGTAGATATGGGCAGCCA
TCTAGCCTAGGAAAAGGTT -> CTAGCCTAGGAAAAGGTTA
GATCAGTTTGGCCCTCCGA -> ATCAGTTTGGCCCTCCGAT
AGTGGTAAGCCCACAGTCC -> GTGGTAAGCCCACAGTCCT
AGAGACATGATCGCCGCGA -> GAGACATGATCGCCGCGAC
AACCAAACAGCCCGAGCGG -> ACCAAACAGCCCGAGCGGT
TAGCTCAGTCATAGTTCAT -> AGCTCAGTCATAGTTCATT
CATGCAAGGCTTGAAGCAT -> ATGCAAGGCTTGAAGCATG
TGACCACCGGCCTTAGAAT -> GACCACCGGCCTTAGAATA
GACAAGCACACTGTCATTA -> ACAAGCACACTGTCATTAT
GTACGCCTGCACAGGGCTT -> TACGCCTGCACAGGGCTTC
CAATAAATGTTTGGTCGGC -> AATAAATGTTTGGTCGGCA
AACGACATGCCTCGAGCAA -> ACGACATGCCTCGAGCAAA
TCGGCTAGAAACCACATTG -> CGGCTAGAAACCACATTGC
TTGTCTCGTCCGTGTAATC -> TGTCTCGTCCGTGTAATCC
GTGTAATTGACTTAACCCG -> TGTAATTGACTTAACCCGA
GTGGTAACCACCATTAAAG -> TGGTAACCACCATTAAAGT
CTCATTCGCGGCACACTAC -> TCATTCGCGGCACACTACA
AACAGCCCGAGCGGTTGCG -> ACAGCCCGAGCGGTTGCGA
AGTTCATCAATGCACACGC -> GTTCATCAATGCACACGCC
TTGTATGTGGTAACCACCA -> TGTATGTGGTAACCACCAT
ATCCCACAGTCCGACGGAC -> TCCCACAGTCCGACGGACA
TGGCCCTCCGATTTCGGCT -> GGCCCTCCGATTTCGGCTA
TTACTCGTCCGACGGCTTC -> TACTCGTCCGACGGCTTCT
TTCATTAAGTAAATTCCAG -> TCATTAAGTAAATTCCAGC
CTTGCGGAATTAAGTAGAT -> TTGCGGAATTAAGTAGATA
CAGCCGCCCGAGTCAAGTA -> AGCCGCCCGAGTCAAGTAG
GTGGAATTTCGCCCTTCAG -> TGGAATTTCGCCCTTCAGT
GTTCGCAGACTTTGCATGC -> TTCGCAGACTTTGCATGCA
CACGTATTCAGTACTCAAT -> ACGTATTCAGTACTCAATG
CAGCCCGAGCGGTTGCGAT -> AGCCCGAGCGGTTGCGATC
TAGCCCCCAAGCTTGTATG -> AGCCCCCAAGCTTGTATGT
CAGTGGGCGCAAGGAAACC -> AGTGGGCGCAAGGAAACCA
AATGCACACGCCGTTGTCT -> ATGCACACGCCGTTGTCTC
CCCTCCACCAGTCCTCATG -> CCTCCACCAGTCCTCATGA
CAGGACAAATGCTTAGAAC -> AGGACAAATGCTTAGAACA
GCCCTCGGGAACGGAGGAG -> CCCTCGGGAACGGAGGAGC
ACTTTTCGCTGCGTGGCTG -> CTTTTCGCTGCGTGGCTGA
GGTCAGGATTGAAATTCTG -> GTCAGGATTGAAATTCTGC
ACACGTTCGCATATTCAAG -> CACGTTCGCATATTCAAGT
AAGTAACGGGGCAGCACCT -> AGTAACGGGGCAGCACCTG
CAACTACAACAGTTCATCA -> AACTACAACAGTTCATCAA
AAATAAACATGCATATGCT -> AATAAACATGCATATGCTA
AATGGAGTTGTCTGGGAAG -> ATGGAGTTGTCTGGGAAGT
TTTTTAGTCAGTTCGGTAC -> TTTTAGTCAGTTCGGTACC
GGGCATAGCTCAGTCATAG -> GGCATAGCTCAGTCATAGT
CTGGGAGTATGTCCTCTGC -> TGGGAGTATGTCCTCTGCA
AGCCACAACTCGCGCTATG -> GCCACAACTCGCGCTATGG
CGTTGTCTCGCCCGCGTAT -> GTTGTCTCGCCCGCGTATG
AGCTCCACATGCGTTCCAA -> GCTCCACATGCGTTCCAAA
CTCATAACTACGGTCTCTT -> TCATAACTACGGTCTCTTG
TTGCATCTCCAAGTCATGG -> TGCATCTCCAAGTCATGGG
CAAGAGCTTGCGTTGTTAT -> AAGAGCTTGCGTTGTTATA
CTAAATAAACATGCATATG -> TAAATAAACATGCATATGC
AAATGCTTAGAACAAATGG -> AATGCTTAGAACAAATGGA
GAGTTGTCTCAAGCAGAGT -> AGTTGTCTCAAGCAGAGTG
GGTGTAATTGACTTAACCC -> GTGTAATTGACTTAACCCG
CTAGCCTAGGAAAAGGTTA -> TAGCCTAGGAAAAGGTTAT
CCGCCCGAGTCAAGTAGGC -> CGCCCGAGTCAAGTAGGCG
CTCGCCCGCGTATGGGGCA -> TCGCCCGCGTATGGGGCAG
AGTCCTCATGAAAGACAAG -> GTCCTCATGAAAGACAAGC
GTGCTCCTTTTTTTGTTGT -> TGCTCCTTTTTTTGTTGTC
TTAGGGAATTTCGCCCTTC -> TAGGGAATTTCGCCCTTCA
GACCGAATTTCGCCCTTCA -> ACCGAATTTCGCCCTTCAG
GTTATACGTTGTATAGTAC -> TTATACGTTGTATAGTACA
GTCCGTGTAATCCCACAGT -> TCCGTGTAATCCCACAGTC
CAGTCCTCATGAAAGACAA -> AGTCCTCATGAAAGACAAG
TGGGATGTACAATAGGTTA -> GGGATGTACAATAGGTTAG
CAGTCCTGTCTCGTTTCTG -> AGTCCTGTCTCGTTTCTGT
CTCGGTGTAATTGACTTAA -> TCGGTGTAATTGACTTAAC
ACAAGCACACTGTCATTAT -> CAAGCACACTGTCATTATA
GGGTCGTTGGTTAGGCAGA -> GGTCGTTGGTTAGGCAGAA
ATGGGTCAGGATTGAAATT -> TGGGTCAGGATTGAAATTC
GTGTAGCGGTCACCCAATA -> TGTAGCGGTCACCCAATAT
GAGCAAATGGTGAACAACT -> AGCAAATGGTGAACAACTA
GGTATTGACTAGACGGGTA -> GTATTGACTAGACGGGTAA
TCAAGTACGGGACGCTCCT -> CAAGTACGGGACGCTCCTC
ACGCAATGCTAAATAAACA -> CGCAATGCTAAATAAACAT
CTCGGGAACGGAGGAGCTC -> TCGGGAACGGAGGAGCTCA
AGTTACCAGAATCGACGCT -> GTTACCAGAATCGACGCTG
ATGACTTGTCGGGTATACG -> TGACTTGTCGGGTATACGT
GACCCCCGCACGACGCGAG -> ACCCCCGCACGACGCGAGA
CGGTTGCGATCAAAGAGAT -> GGTTGCGATCAAAGAGATG
CCATCTCATAACTACGGTC -> CATCTCATAACTACGGTCT
TGATAGCGCTTATCGCGGG -> GATAGCGCTTATCGCGGGT
CTGAAGTCTCCCTCTGTCG -> TGAAGTCTCCCTCTGTCGT
AGCTCTGACCACCGGCCTT -> GCTCTGACCACCGGCCTTA
CGCAGATAGCCAAATCCGA -> GCAGATAGCCAAATCCGAC
CAGGGCGGTACGGGTGTAC -> AGGGCGGTACGGGTGTACG
TGAACAACTACAACAGTTC -> GAACAACTACAACAGTTCA
TAAATTCCAGCCATTTTCG -> AAATTCCAGCCATTTTCGG
AAATTACTATTTGGCACTC -> AATTACTATTTGGCACTCA
TTCTGCACGATCGACATTC -> TCTGCACGATCGACATTCT
GCGGTTGCGATCAAAGAGA -> CGGTTGCGATCAAAGAGAT
GTCAGTAATTCATTCCTGT -> TCAGTAATTCATTCCTGTA
TTCAGTACTCAATGGAGGC -> TCAGTACTCAATGGAGGCG
TGTTGTCTCGTCCGTGTAA -> GTTGTCTCGTCCGTGTAAT
GGGCAGCACCTGCGTTGAT -> GGCAGCACCTGCGTTGATA
TCTCGTTTCTGTATGAGCA -> CTCGTTTCTGTATGAGCAC
TACCGATAGTGTAGCGGTC -> ACCGATAGTGTAGCGGTCA
TGTACAATAGGTTAGTTGC -> GTACAATAGGTTAGTTGCA
CAAATGGAGTTGTCTGGGA -> AAATGGAGTTGTCTGGGAA
GGAGTTGTCTAACGTTGGA -> GAGTTGTCTAACGTTGGAG
AGGGGTCGTTGGTTAGGCA -> GGGGTCGTTGGTTAGGCAG
GGATTGAAATTCTGCACGA -> GATTGAAATTCTGCACGAT
GGATTAATGGCGCTCTCAG -> GATTAATGGCGCTCTCAGG
GGTTTGGTCACAAGTTAGC -> GTTTGGTCACAAGTTAGCA
GTGGCATGCAAGGCTTGAA -> TGGCATGCAAGGCTTGAAG
CGGAGAGACATGATCGCCG -> GGAGAGACATGATCGCCGC
TGTCGACGACCCTTGCCGA -> GTCGACGACCCTTGCCGAT
GTGTAATCCCACAGTCCGA -> TGTAATCCCACAGTCCGAC
CCAACAAGTACCCCGTCAC -> CAACAAGTACCCCGTCACC
ATGCTTGCGCTCATGTGCA -> TGCTTGCGCTCATGTGCAA
GAATCAACCACAGTTCAAG -> AATCAACCACAGTTCAAGA
TTTGGCACTCACGGACCCC -> TTGGCACTCACGGACCCCC
GTTTGGTCGGCACTAAGCT -> TTTGGTCGGCACTAAGCTG
ACCCTTGCCGATACAGCTC -> CCCTTGCCGATACAGCTCC
CAACAGTTCATCAATGCAC -> AACAGTTCATCAATGCACA
GCGTCTGCGATTAAAGCTG -> CGTCTGCGATTAAAGCTGT
TCCGACGGCTTCTGCGACG -> CCGACGGCTTCTGCGACGA
TAACTACGGTCTCTTGGCG -> AACTACGGTCTCTTGGCGA
ACAGGGTCAAGAGACACCG -> CAGGGTCAAGAGACACCGC
CTCCTCAATAAATGTTTGG -> TCCTCAATAAATGTTTGGT
ACATGCATATGCTATTCCG -> CATGCATATGCTATTCCGC
AATGTCGACGACCCTTGCC -> ATGTCGACGACCCTTGCCG
GGCACTAAGCTGGTATTGA -> GCACTAAGCTGGTATTGAC
TGGTAAGCCCACAGTCCTG -> GGTAAGCCCACAGTCCTGT
AGCAGAGTGGAATTTCGCC -> GCAGAGTGGAATTTCGCCC
CGACGGACACGAACAAATG -> GACGGACACGAACAAATGG
GAGACATGATCGCCGCGAC -> AGACATGATCGCCGCGACG
CTCCAAGTCATGGGTAAGC -> TCCAAGTCATGGGTAAGCC
TTAAGTAGATATGGGCAGC -> TAAGTAGATATGGGCAGCC
ACGTTGGAGTGAACAAATG -> CGTTGGAGTGAACAAATGG
TCAGGATTGAAATTCTGCA -> CAGGATTGAAATTCTGCAC
TATTGCGATTTTTAGTCAG -> ATTGCGATTTTTAGTCAGT
AGCATGCTGCCCTCCACCA -> GCATGCTGCCCTCCACCAG
TTAAGGGTAAATTACTATT -> TAAGGGTAAATTACTATTT
CATTTAAGGGTAAATTACT -> ATTTAAGGGTAAATTACTA
ATTTCGCCCTTCAGTGGGG -> TTTCGCCCTTCAGTGGGGA
GAAAGTAGACTTTTTGAAC -> AAAGTAGACTTTTTGAACG
CAGACCAGGGCGGTACGGG -> AGACCAGGGCGGTACGGGT
ACTGTCATTATATGCCCTG -> CTGTCATTATATGCCCTGC
TTGTTATAGTCCTGGCACT -> TGTTATAGTCCTGGCACTT
ATAACTACGGTCTCTTGGC -> TAACTACGGTCTCTTGGCG
TGAGCCACGTATTCAGTAC -> GAGCCACGTATTCAGTACT
AGTGAACAAATGGAGTTGT -> GTGAACAAATGGAGTTGTC
ATGACCCGTTTTTGAGGGC -> TGACCCGTTTTTGAGGGCA
GGACCCCCGCACGACGCGA -> GACCCCCGCACGACGCGAG
GAAAGAAATCGGCTCCCGC -> AAAGAAATCGGCTCCCGCC
TTGATAGCGCTTATCGCGG -> TGATAGCGCTTATCGCGGG
GGGGTCGTTGGTTAGGCAG -> GGGTCGTTGGTTAGGCAGA
AAGAGCACTCAAACGTCAA -> AGAGCACTCAAACGTCAAG
CCCTTCAGTGGGCGCAAGG -> CCTTCAGTGGGCGCAAGGA
TAGTACAGGATTAATGGCG -> AGTACAGGATTAATGGCGC
CCGCACGACGCGAGAGCGA -> CGCACGACGCGAGAGCGAA
GTCGGCACTAAGCTGGTAT -> TCGGCACTAAGCTGGTATT
TTTTGAACGACATGCCTCG -> TTTGAACGACATGCCTCGA
GTCAAGAGACACCGCGGCG -> TCAAGAGACACCGCGGCGC
CAGCCACGAAAGTAGACTT -> AGCCACGAAAGTAGACTTT
ACGGAGGAGCTCAATGACC -> CGGAGGAGCTCAATGACCC
CGCAATGCTAAATAAACAT -> GCAATGCTAAATAAACATG
GCCCTCCACCAGTCCTCAT -> CCCTCCACCAGTCCTCATG
CGCTTATCGCGGGTGTCAC -> GCTTATCGCGGGTGTCACT
TGCAGCCGCCCGAGTCAAG -> GCAGCCGCCCGAGTCAAGT
GCCACGAAAGTAGACTTTT -> CCACGAAAGTAGACTTTTT
GTCGGGTATACGTGCAGCC -> TCGGGTATACGTGCAGCCG
GAGATTCTTGCGGAATTAA -> AGATTCTTGCGGAATTAAG
GGCAGAAGTTGCGCATGCT -> GCAGAAGTTGCGCATGCTT
ATACAGCTCCACATGCGTT -> TACAGCTCCACATGCGTTC
GGTTATACGTTGTATAGTA -> GTTATACGTTGTATAGTAC
TCGCTGCGTGGCTGACGGT -> CGCTGCGTGGCTGACGGTC
GCGACGCGGAGGCAGAAGT -> CGACGCGGAGGCAGAAGTT
TCCTCTGCAATGAGCAAAT -> CCTCTGCAATGAGCAAATG
TAGAACAAATGGAGTTGTC -> AGAACAAATGGAGTTGTCT
ATAAGACGCAATGCTAAAT -> TAAGACGCAATGCTAAATA
GCCAAATCCGACGCCTAGA -> CCAAATCCGACGCCTAGAG
CTGCAATGAGCAAATGGTG -> TGCAATGAGCAAATGGTGA
CGAGTCAAGTAGGCGACGA -> GAGTCAAGTAGGCGACGAA
CTGGCACTTAGCGAAAGAA -> TGGCACTTAGCGAAAGAAA
CCAGCCATTTTCGGAGATT -> CAGCCATTTTCGGAGATTC
CGCCCGCGTATGGGGCAGG -> GCCCGCGTATGGGGCAGGA
AAGGGATACCGATGGACGC -> AGGGATACCGATGGACGCC
TTTCGGAGATTCTTGCGGA -> TTCGGAGATTCTTGCGGAA
AGGAAAAGGTTATACGTTG -> GGAAAAGGTTATACGTTGT
ATATTGCGATTTTTAGTCA -> TATTGCGATTTTTAGTCAG
TTTGGTCACAAGTTAGCAC -> TTGGTCACAAGTTAGCACA
GAATATAGAGATGGGTCAA -> AATATAGAGATGGGTCAAA
TCGCAGATAGCCAAATCCG -> CGCAGATAGCCAAATCCGA
GCGGGTGTCACTTGGTAGT -> CGGGTGTCACTTGGTAGTA
GTCTGCGATTAAAGCTGTG -> TCTGCGATTAAAGCTGTGG
TACGCACTTTTCGCTGCGT -> ACGCACTTTTCGCTGCGTG
CTTGAAGCATGCTGCCCTC -> TTGAAGCATGCTGCCCTCC
CTCGTCCGACGGCTTCTGC -> TCGTCCGACGGCTTCTGCG
CGATTTTTAGTCAGTTCGG -> GATTTTTAGTCAGTTCGGT
AATTACTATTTGGCACTCA -> ATTACTATTTGGCACTCAC
AGATAGCCAAATCCGACGC -> GATAGCCAAATCCGACGCC
TTCGGCTAGAAACCACATT -> TCGGCTAGAAACCACATTG
AAACAGCCCGAGCGGTTGC -> AACAGCCCGAGCGGTTGCG
ACCACCATTAAAGTCCGCT -> CCACCATTAAAGTCCGCTT
CCGCAAGTAGATACCGATA -> CGCAAGTAGATACCGATAG
TGAAGCATGCTGCCCTCCA -> GAAGCATGCTGCCCTCCAC
TTTTCGCTGCGTGGCTGAC -> TTTCGCTGCGTGGCTGACG
TCATGAAAGACAAGCACAC -> CATGAAAGACAAGCACACT
CCTTCAGTGGTGCCGCAAG -> CTTCAGTGGTGCCGCAAGT
AGGGAATTTCGCCCTTCAG -> GGGAATTTCGCCCTTCAGT
GAAACCAAACAGCCCGAGC -> AAACCAAACAGCCCGAGCG
TCGTTGGTTAGGCAGAAAT -> CGTTGGTTAGGCAGAAATG
ACCCCCGCACGACGCGAGA -> CCCCCGCACGACGCGAGAG
CACGGACCCCCGCACGACG -> ACGGACCCCCGCACGACGC
CCTACGATCTGTGTCAACG -> CTACGATCTGTGTCAACGT
TACGCCTGCACAGGGCTTC -> ACGCCTGCACAGGGCTTCT
GGGCAATCGGTTTCTAGCC -> GGCAATCGGTTTCTAGCCT
GCGACGAAAGCGTCTGCGA -> CGACGAAAGCGTCTGCGAT
TGACTTGTCGGGTATACGT -> GACTTGTCGGGTATACGTG
CGTGGTTACGTCCTCCTCG -> GTGGTTACGTCCTCCTCGG
TGGGTCAGGATTGAAATTC -> GGGTCAGGATTGAAATTCT
TCGCAGACTTTGCATGCAT -> CGCAGACTTTGCATGCATA
GCGCATGCTTGCGCTCATG -> CGCATGCTTGCGCTCATGT
AGGATTGAAATTCTGCACG -> GGATTGAAATTCTGCACGA
GCGTTGATAGCGCTTATCG -> CGTTGATAGCGCTTATCGC
GACGCTCCTCAATAAATGT -> ACGCTCCTCAATAAATGTT
AACTACAACAGTTCATCAA -> ACTACAACAGTTCATCAAT
GGGAAGTTAGGGAATTTCG -> GGAAGTTAGGGAATTTCGC
CGCTGCGTGGCTGACGGTC -> GCTGCGTGGCTGACGGTCA
GAATTAAGTAGATATGGGC -> AATTAAGTAGATATGGGCA
CTTCAGTGGGGAATTTCGC -> TTCAGTGGGGAATTTCGCC
GAAAGACAAGCACACTGTC -> AAAGACAAGCACACTGTCA
GTCAAGCAATCTGGGCAAT -> TCAAGCAATCTGGGCAATC
ACCGGCCTTAGAATAGAGC -> CCGGCCTTAGAATAGAGCT
GCACACACGTGGTTACGTC -> CACACACGTGGTTACGTCC
GGAACAAATGGAGTTGTCT -> GAACAAATGGAGTTGTCTG
TTCGCATATTCAAGTACGG -> TCGCATATTCAAGTACGGG
CCCTACGATCTGTGTCAAC -> CCTACGATCTGTGTCAACG
CTATTCCGCAGTGGCCGAA -> TATTCCGCAGTGGCCGAAC
CAAGAGACACCGCGGCGCA -> AAGAGACACCGCGGCGCAT
TAGTACGCCTGCACAGGGC -> AGTACGCCTGCACAGGGCT
GGGTAAATTACTATTTGGC -> GGTAAATTACTATTTGGCA
AAAGAGATGGTTCACCTTG -> AAGAGATGGTTCACCTTGC
GCTAAATAAACATGCATAT -> CTAAATAAACATGCATATG
GGCCGAACAGAGCCGAGTT -> GCCGAACAGAGCCGAGTTA
TCATTCCTGTAGCCCTCAA -> CATTCCTGTAGCCCTCAAC
ACCAACAAGTACCCCGTCA -> CCAACAAGTACCCCGTCAC
GATATGGGCAGCCACGAAA -> ATATGGGCAGCCACGAAAG
ACATGATCGCCGCGACGCG -> CATGATCGCCGCGACGCGG
GTTCGCATATTCAAGTACG -> TTCGCATATTCAAGTACGG
TAAATTACTATTTGGCACT -> AAATTACTATTTGGCACTC
AAACATGCATATGCTATTC -> AACATGCATATGCTATTCC
GACGACCCTTGCCGATACA -> ACGACCCTTGCCGATACAG
CCCTCAACAACGTCCAACG -> CCTCAACAACGTCCAACGC
GTAAATTACTATTTGGCAC -> TAAATTACTATTTGGCACT
CTTCAGTGGTGCCGCAAGT -> TTCAGTGGTGCCGCAAGTA
GGAAAAGGTTATACGTTGT -> GAAAAGGTTATACGTTGTA
AAGCTGTGGTTGAGTGGCC -> AGCTGTGGTTGAGTGGCCC
GCTATTCCGCAGTGGCCGA -> CTATTCCGCAGTGGCCGAA
CAGTTCGGTACCACACGTT -> AGTTCGGTACCACACGTTC
TTCAGTGGCATGCAAGGCT -> TCAGTGGCATGCAAGGCTT
GCCCTGCCGGAGAGACATG -> CCCTGCCGGAGAGACATGA
CTTTTCGCTGCGTGGCTGA -> TTTTCGCTGCGTGGCTGAC
GACGCGGAGGCAGAAGTTG -> ACGCGGAGGCAGAAGTTGC
ACAGTTCATCAATGCACAC -> CAGTTCATCAATGCACACG
TTAAGAGCACTCAAACGTC -> TAAGAGCACTCAAACGTCA
GCCGCCCGAGTCAAGTAGG -> CCGCCCGAGTCAAGTAGGC
AGTCTCCCTCTGTCGTGAA -> GTCTCCCTCTGTCGTGAAC
TGTCCTCTGCAATGAGCAA -> GTCCTCTGCAATGAGCAAA
ACACCGCGGCGCATACAGT -> CACCGCGGCGCATACAGTG
CCACCGGCCTTAGAATAGA -> CACCGGCCTTAGAATAGAG
CACGAACAAATGGAGTTGT -> ACGAACAAATGGAGTTGTC
AGTTGTCTAACGTTGGAGT -> GTTGTCTAACGTTGGAGTG
TTGGCACTCACGGACCCCC -> TGGCACTCACGGACCCCCG
CCAAAGACCTGGGATGTAC -> CAAAGACCTGGGATGTACA
AGTAATTCATTCCTGTAGC -> GTAATTCATTCCTGTAGCC
TGCCCTCGGGAACGGAGGA -> GCCCTCGGGAACGGAGGAG
ATTGCGATTTTTAGTCAGT -> TTGCGATTTTTAGTCAGTT
TAGGCAGAAATGTCGACGA -> AGGCAGAAATGTCGACGAC
CCTCAATAAATGTTTGGTC -> CTCAATAAATGTTTGGTCG
TCGTCCGTGTAATCCCACA -> CGTCCGTGTAATCCCACAG
CCTTCAGTGGCATGCAAGG -> CTTCAGTGGCATGCAAGGC
ACATGCCTCGAGCAAAGAT -> CATGCCTCGAGCAAAGATG
GTGGTTGAGTGGCCCCTCC -> TGGTTGAGTGGCCCCTCCC
AGGGCATAGCTCAGTCATA -> GGGCATAGCTCAGTCATAG
GATAAATAAGACGCAATGC -> ATAAATAAGACGCAATGCT
CATAAAGTCAGTTACCAGA -> ATAAAGTCAGTTACCAGAC
ACAACAGTTCATCAATGCA -> CAACAGTTCATCAATGCAC
TCGGCTCCCGCCCTACGAT -> CGGCTCCCGCCCTACGATC
ACAACTGTGCTCCTTTTTT -> CAACTGTGCTCCTTTTTTT
CTAGACGGGTAAAGTCGAG -> TAGACGGGTAAAGTCGAGT
AAGTCTCCCTCTGTCGTGA -> AGTCTCCCTCTGTCGTGAA
GCCTCGAGCAAAGATGAGC -> CCTCGAGCAAAGATGAGCC
TTTCTAGCCTAGGAAAAGG -> TTCTAGCCTAGGAAAAGGT
AGTCAAGTAGGCGACGAAA -> GTCAAGTAGGCGACGAAAG
AAAGTAGACTTTTTGAACG -> AAGTAGACTTTTTGAACGA
CATTCGCGGCACACTACAT -> ATTCGCGGCACACTACATG
TGAACGACATGCCTCGAGC -> GAACGACATGCCTCGAGCA
ATTGAATATAGAGATGGGT -> TTGAATATAGAGATGGGTC
CAACCACAGTTCAAGAGCT -> AACCACAGTTCAAGAGCTT
ATCACCAACAAGTACCCCG -> TCACCAACAAGTACCCCGT
AGGCAGAAGTTGCGCATGC -> GGCAGAAGTTGCGCATGCT
TACAGTGGTAAGCCCACAG -> ACAGTGGTAAGCCCACAGT
GGATACCGATGGACGCCAT -> GATACCGATGGACGCCATC
TCTGTGTCAACGTGCCCTC -> CTGTGTCAACGTGCCCTCG
CCTCGGTGTAATTGACTTA -> CTCGGTGTAATTGACTTAA
ACTCTATTCGCAGATAGCC -> CTCTATTCGCAGATAGCCA
TGCCCTCCACCAGTCCTCA -> GCCCTCCACCAGTCCTCAT
TCGACATTCTACATAAAGT -> CGACATTCTACATAAAGTC
ATGCTATTCCGCAGTGGCC -> TGCTATTCCGCAGTGGCCG
ACTCGCGCTATGGCAAGTA -> CTCGCGCTATGGCAAGTAA
AGTGGGGAATTTCGCCCTT -> GTGGGGAATTTCGCCCTTC
GCCGAACAGAGCCGAGTTA -> CCGAACAGAGCCGAGTTAC
GTTGTCTCAAGCAGAGTGG -> TTGTCTCAAGCAGAGTGGA
AGTCCTGGCACTTAGCGAA -> GTCCTGGCACTTAGCGAAA
TGCACACGCCGTTGTCTCG -> GCACACGCCGTTGTCTCGC
CGATACAGCTCCACATGCG -> GATACAGCTCCACATGCGT
CCAGTCCTCATGAAAGACA -> CAGTCCTCATGAAAGACAA
TTCAAGTACGGGACGCTCC -> TCAAGTACGGGACGCTCCT
AAGAGCTTGCGTTGTTATA -> AGAGCTTGCGTTGTTATAG
TACCGATGGACGCCATCTC -> ACCGATGGACGCCATCTCA
GCGCATACAGTGGTAAGCC -> CGCATACAGTGGTAAGCCC
GGAAGTTAGGGAATTTCGC -> GAAGTTAGGGAATTTCGCC
TCTTACGCGGGACCGAATT -> CTTACGCGGGACCGAATTT
TCACGGACCCCCGCACGAC -> CACGGACCCCCGCACGACG
AACAACGTCCAACGCGCAG -> ACAACGTCCAACGCGCAGA
GCACTTAGCGAAAGAAATC -> CACTTAGCGAAAGAAATCG
ACACTGTCATTATATGCCC -> CACTGTCATTATATGCCCT
CGTCCGACGGCTTCTGCGA -> GTCCGACGGCTTCTGCGAC
CGCAGTGGCCGAACAGAGC -> GCAGTGGCCGAACAGAGCC
ACGGGTAAAGTCGAGTTCG -> CGGGTAAAGTCGAGTTCGC
CCGCGACGCGGAGGCAGAA -> CGCGACGCGGAGGCAGAAG
GTCATGGGTAAGCCTGAAG -> TCATGGGTAAGCCTGAAGT
AGCCACGAAAGTAGACTTT -> GCCACGAAAGTAGACTTTT
CTGGGATGTACAATAGGTT -> TGGGATGTACAATAGGTTA
AGCCCACAGTCCTGTCTCG -> GCCCACAGTCCTGTCTCGT
GCATACAGTGGTAAGCCCA -> CATACAGTGGTAAGCCCAC
ACGAAAGCGTCTGCGATTA -> CGAAAGCGTCTGCGATTAA
TGGGTAAGCCTGAAGTCTC -> GGGTAAGCCTGAAGTCTCC
AAGCAATCTGGGCAATCGG -> AGCAATCTGGGCAATCGGT
ATGGAGTTGTCTGGGAAGT -> TGGAGTTGTCTGGGAAGTT
CCCTCCCACCCCTGCTGGG -> CCTCCCACCCCTGCTGGGA
GGCGTCAGTAATTCATTCC -> GCGTCAGTAATTCATTCCT
TTGAAGCATGCTGCCCTCC -> TGAAGCATGCTGCCCTCCA
GCAGATCAGCCACAACTCG -> CAGATCAGCCACAACTCGC
ACGGACCCCCGCACGACGC -> CGGACCCCCGCACGACGCG
GCACTAAGCTGGTATTGAC -> CACTAAGCTGGTATTGACT
TGGGCGCAAGGAAACCAAA -> GGGCGCAAGGAAACCAAAC
CCCTCGGGAACGGAGGAGC -> CCTCGGGAACGGAGGAGCT
