CGGAGCGAAGG -> GGAGCGAAGGA
GGAGCGAAGGA -> GAGCGAAGGAT
GAGCGAAGGAT -> AGCGAAGGATC
AGCGAAGGATC -> GCGAAGGATCG
GCGAAGGATCG -> CGAAGGATCGA
CGAAGGATCGA -> GAAGGATCGAG
GAAGGATCGAG -> AAGGATCGAGG
AAGGATCGAGG -> AGGATCGAGGA
AGGATCGAGGA -> GGATCGAGGAG
GGATCGAGGAG -> GATCGAGGAGG
GATCGAGGAGG -> ATCGAGGAGGG
ATCGAGGAGGG -> TCGAGGAGGGC
TCGAGGAGGGC -> CGAGGAGGGCT
CGAGGAGGGCT -> GAGGAGGGCTC
GAGGAGGGCTC -> AGGAGGGCTCG
AGGAGGGCTCG -> GGAGGGCTCGG
GGAGGGCTCGG -> GAGGGCTCGGT
GAGGGCTCGGT -> AGGGCTCGGTA
AGGGCTCGGTA -> GGGCTCGGTAC
GGGCTCGGTAC -> GGCTCGGTACG
GGCTCGGTACG -> GCTCGGTACGG
GCTCGGTACGG -> CTCGGTACGGG
CTCGGTACGGG -> TCGGTACGGGA
TCGGTACGGGA -> CGGTACGGGAG
CGGTACGGGAG -> GGTACGGGAGG
GGTACGGGAGG -> GTACGGGAGGG
GTACGGGAGGG -> TACGGGAGGGT
TACGGGAGGGT -> ACGGGAGGGTA
ACGGGAGGGTA -> CGGGAGGGTAT
CGGGAGGGTAT -> GGGAGGGTATC
GGGAGGGTATC -> GGAGGGTATCT
GGAGGGTATCT -> GAGGGTATCTC
GAGGGTATCTC -> AGGGTATCTCT
AGGGTATCTCT -> GGGTATCTCTC
GGGTATCTCTC -> GGTATCTCTCC
GGTATCTCTCC -> GTATCTCTCCC
GTATCTCTCCC -> TATCTCTCCCC
TATCTCTCCCC -> ATCTCTCCCCG
ATCTCTCCCCG -> TCTCTCCCCGG
TCTCTCCCCGG -> CTCTCCCCGGG
CTCTCCCCGGG -> TCTCCCCGGGA
TCTCCCCGGGA -> CTCCCCGGGAA
CTCCCCGGGAA -> TCCCCGGGAAT
TCCCCGGGAAT -> CCCCGGGAATA
CCCCGGGAATA -> CCCGGGAATAT
CCCGGGAATAT -> CCGGGAATATC
CCGGGAATATC -> CGGGAATATCA
CGGGAATATCA -> GGGAATATCAC
GGGAATATCAC -> GGAATATCACT
GGAATATCACT -> GAATATCACTG
GAATATCACTG -> AATATCACTGA
AATATCACTGA -> ATATCACTGAT
ATATCACTGAT -> TATCACTGATT
TATCACTGATT -> ATCACTGATTG
ATCACTGATTG -> TCACTGATTGT
TCACTGATTGT -> CACTGATTGTA
CACTGATTGTA -> ACTGATTGTAG
ACTGATTGTAG -> CTGATTGTAGC
CTGATTGTAGC -> TGATTGTAGCG
TGATTGTAGCG -> GATTGTAGCGG
GATTGTAGCGG -> ATTGTAGCGGT
ATTGTAGCGGT -> TTGTAGCGGTT
TTGTAGCGGTT -> TGTAGCGGTTC
TGTAGCGGTTC -> GTAGCGGTTCC
GTAGCGGTTCC -> TAGCGGTTCCT
TAGCGGTTCCT -> AGCGGTTCCTG
AGCGGTTCCTG -> GCGGTTCCTGT
GCGGTTCCTGT -> CGGTTCCTGTG
CGGTTCCTGTG -> GGTTCCTGTGT
GGTTCCTGTGT -> GTTCCTGTGTC
GTTCCTGTGTC -> TTCCTGTGTCA
TTCCTGTGTCA -> TCCTGTGTCAG
TCCTGTGTCAG -> CCTGTGTCAGA
CCTGTGTCAGA -> CTGTGTCAGAG
CTGTGTCAGAG -> TGTGTCAGAGG
TGTGTCAGAGG -> GTGTCAGAGGG
GTGTCAGAGGG -> TGTCAGAGGGA
TGTCAGAGGGA -> GTCAGAGGGAA
GTCAGAGGGAA -> TCAGAGGGAAA
TCAGAGGGAAA -> CAGAGGGAAAG
CAGAGGGAAAG -> AGAGGGAAAGT
AGAGGGAAAGT -> GAGGGAAAGTC
GAGGGAAAGTC -> AGGGAAAGTCC
AGGGAAAGTCC -> GGGAAAGTCCT
GGGAAAGTCCT -> GGAAAGTCCTC
GGAAAGTCCTC -> GAAAGTCCTCC
GAAAGTCCTCC -> AAAGTCCTCCC
AAAGTCCTCCC -> AAGTCCTCCCA
AAGTCCTCCCA -> AGTCCTCCCAT
AGTCCTCCCAT -> GTCCTCCCATC
GTCCTCCCATC -> TCCTCCCATCT
TCCTCCCATCT -> CCTCCCATCTT
CCTCCCATCTT -> CTCCCATCTTG
CTCCCATCTTG -> TCCCATCTTGT
TCCCATCTTGT -> CCCATCTTGTC
CCCATCTTGTC -> CCATCTTGTCT
CCATCTTGTCT -> CATCTTGTCTG
CATCTTGTCTG -> ATCTTGTCTGT
ATCTTGTCTGT -> TCTTGTCTGTC
TCTTGTCTGTC -> CTTGTCTGTCT
CTTGTCTGTCT -> TTGTCTGTCTT
TTGTCTGTCTT -> TGTCTGTCTTG
TGTCTGTCTTG -> GTCTGTCTTGC
GTCTGTCTTGC -> TCTGTCTTGCC
TCTGTCTTGCC -> CTGTCTTGCCC
CTGTCTTGCCC -> TGTCTTGCCCG
TGTCTTGCCCG -> GTCTTGCCCGC
GTCTTGCCCGC -> TCTTGCCCGCG
TCTTGCCCGCG -> CTTGCCCGCGA
CTTGCCCGCGA -> TTGCCCGCGAG
TTGCCCGCGAG -> TGCCCGCGAGT
TGCCCGCGAGT -> GCCCGCGAGTC
GCCCGCGAGTC -> CCCGCGAGTCG
CCCGCGAGTCG -> CCGCGAGTCGT
CCGCGAGTCGT -> CGCGAGTCGTT
CGCGAGTCGTT -> GCGAGTCGTTC
GCGAGTCGTTC -> CGAGTCGTTCG
CGAGTCGTTCG -> GAGTCGTTCGA
GAGTCGTTCGA -> AGTCGTTCGAC
AGTCGTTCGAC -> GTCGTTCGACC
GTCGTTCGACC -> TCGTTCGACCG
TCGTTCGACCG -> CGTTCGACCGT
CGTTCGACCGT -> GTTCGACCGTA
GTTCGACCGTA -> TTCGACCGTAT
TTCGACCGTAT -> TCGACCGTATC
TCGACCGTATC -> CGACCGTATCT
CGACCGTATCT -> GACCGTATCTC
GACCGTATCTC -> ACCGTATCTCC
ACCGTATCTCC -> CCGTATCTCCG
CCGTATCTCCG -> CGTATCTCCGA
CGTATCTCCGA -> GTATCTCCGAG
GTATCTCCGAG -> TATCTCCGAGT
TATCTCCGAGT -> ATCTCCGAGTC
ATCTCCGAGTC -> TCTCCGAGTCG
TCTCCGAGTCG -> CTCCGAGTCGA
CTCCGAGTCGA -> TCCGAGTCGAT
TCCGAGTCGAT -> CCGAGTCGATA
CCGAGTCGATA -> CGAGTCGATAG
CGAGTCGATAG -> GAGTCGATAGT
GAGTCGATAGT -> AGTCGATAGTA
AGTCGATAGTA -> GTCGATAGTAA
GTCGATAGTAA -> TCGATAGTAAG
TCGATAGTAAG -> CGATAGTAAGC
CGATAGTAAGC -> GATAGTAAGCA
GATAGTAAGCA -> ATAGTAAGCAT
ATAGTAAGCAT -> TAGTAAGCATG
TAGTAAGCATG -> AGTAAGCATGG
AGTAAGCATGG -> GTAAGCATGGG
GTAAGCATGGG -> TAAGCATGGGC
TAAGCATGGGC -> AAGCATGGGCC
AAGCATGGGCC -> AGCATGGGCCC
AGCATGGGCCC -> GCATGGGCCCA
GCATGGGCCCA -> CATGGGCCCAC
CATGGGCCCAC -> ATGGGCCCACT
ATGGGCCCACT -> TGGGCCCACTG
TGGGCCCACTG -> GGGCCCACTGA
GGGCCCACTGA -> GGCCCACTGAG
GGCCCACTGAG -> GCCCACTGAGT
GCCCACTGAGT -> CCCACTGAGTT
CCCACTGAGTT -> CCACTGAGTTC
CCACTGAGTTC -> CACTGAGTTCA
CACTGAGTTCA -> ACTGAGTTCAG
ACTGAGTTCAG -> CTGAGTTCAGC
CTGAGTTCAGC -> TGAGTTCAGCT
TGAGTTCAGCT -> GAGTTCAGCTG
GAGTTCAGCTG -> AGTTCAGCTGC
AGTTCAGCTGC -> GTTCAGCTGCC
GTTCAGCTGCC -> TTCAGCTGCCC
TTCAGCTGCCC -> TCAGCTGCCCC
TCAGCTGCCCC -> CAGCTGCCCCC
CAGCTGCCCCC -> AGCTGCCCCCA
AGCTGCCCCCA -> GCTGCCCCCAA
GCTGCCCCCAA -> CTGCCCCCAAG
CTGCCCCCAAG -> TGCCCCCAAGC
TGCCCCCAAGC -> GCCCCCAAGCT
GCCCCCAAGCT -> CCCCCAAGCTA
CCCCCAAGCTA -> CCCCAAGCTAG
CCCCAAGCTAG -> CCCAAGCTAGC
CCCAAGCTAGC -> CCAAGCTAGCA
CCAAGCTAGCA -> CAAGCTAGCAC
CAAGCTAGCAC -> AAGCTAGCACT
AAGCTAGCACT -> AGCTAGCACTG
AGCTAGCACTG -> GCTAGCACTGA
GCTAGCACTGA -> CTAGCACTGAC
CTAGCACTGAC -> TAGCACTGACC
TAGCACTGACC -> AGCACTGACCA
AGCACTGACCA -> GCACTGACCAT
GCACTGACCAT -> CACTGACCATC
CACTGACCATC -> ACTGACCATCC
ACTGACCATCC -> CTGACCATCCA
CTGACCATCCA -> TGACCATCCAT
TGACCATCCAT -> GACCATCCATG
GACCATCCATG -> ACCATCCATGG
ACCATCCATGG -> CCATCCATGGT
CCATCCATGGT -> CATCCATGGTG
CATCCATGGTG -> ATCCATGGTGA
ATCCATGGTGA -> TCCATGGTGAG
TCCATGGTGAG -> CCATGGTGAGC
CCATGGTGAGC -> CATGGTGAGCC
CATGGTGAGCC -> ATGGTGAGCCA
ATGGTGAGCCA -> TGGTGAGCCAG
TGGTGAGCCAG -> GGTGAGCCAGA
GGTGAGCCAGA -> GTGAGCCAGAA
GTGAGCCAGAA -> TGAGCCAGAAC
TGAGCCAGAAC -> GAGCCAGAACT
GAGCCAGAACT -> AGCCAGAACTA
AGCCAGAACTA -> GCCAGAACTAA
GCCAGAACTAA -> CCAGAACTAAA
CCAGAACTAAA -> CAGAACTAAAT
CAGAACTAAAT -> AGAACTAAATA
AGAACTAAATA -> GAACTAAATAC
GAACTAAATAC -> AACTAAATACT
AACTAAATACT -> ACTAAATACTC
ACTAAATACTC -> CTAAATACTCC
CTAAATACTCC -> TAAATACTCCT
TAAATACTCCT -> AAATACTCCTA
AAATACTCCTA -> AATACTCCTAC
AATACTCCTAC -> ATACTCCTACA
ATACTCCTACA -> TACTCCTACAT
TACTCCTACAT -> ACTCCTACATC
ACTCCTACATC -> CTCCTACATCA
CTCCTACATCA -> TCCTACATCAC
TCCTACATCAC -> CCTACATCACC
CCTACATCACC -> CTACATCACCA
CTACATCACCA -> TACATCACCAT
TACATCACCAT -> ACATCACCATA
ACATCACCATA -> CATCACCATAC
CATCACCATAC -> ATCACCATACT
ATCACCATACT -> TCACCATACTT
TCACCATACTT -> CACCATACTTC
CACCATACTTC -> ACCATACTTCA
ACCATACTTCA -> CCATACTTCAT
CCATACTTCAT -> CATACTTCATC
CATACTTCATC -> ATACTTCATCC
ATACTTCATCC -> TACTTCATCCC
TACTTCATCCC -> ACTTCATCCCG
ACTTCATCCCG -> CTTCATCCCGA
CTTCATCCCGA -> TTCATCCCGAT
TTCATCCCGAT -> TCATCCCGATG
TCATCCCGATG -> CATCCCGATGT
CATCCCGATGT -> ATCCCGATGTT
ATCCCGATGTT -> TCCCGATGTTG
TCCCGATGTTG -> CCCGATGTTGG
CCCGATGTTGG -> CCGATGTTGGT
CCGATGTTGGT -> CGATGTTGGTG
CGATGTTGGTG -> GATGTTGGTGG
GATGTTGGTGG -> ATGTTGGTGGC
ATGTTGGTGGC -> TGTTGGTGGCT
TGTTGGTGGCT -> GTTGGTGGCTT
GTTGGTGGCTT -> TTGGTGGCTTT
TTGGTGGCTTT -> TGGTGGCTTTT
TGGTGGCTTTT -> GGTGGCTTTTG
GGTGGCTTTTG -> GTGGCTTTTGA
GTGGCTTTTGA -> TGGCTTTTGAC
TGGCTTTTGAC -> GGCTTTTGACA
GGCTTTTGACA -> GCTTTTGACAA
GCTTTTGACAA -> CTTTTGACAAC
CTTTTGACAAC -> TTTTGACAACA
TTTTGACAACA -> TTTGACAACAG
TTTGACAACAG -> TTGACAACAGG
TTGACAACAGG -> TGACAACAGGG
TGACAACAGGG -> GACAACAGGGA
GACAACAGGGA -> ACAACAGGGAA
ACAACAGGGAA -> CAACAGGGAAA
CAACAGGGAAA -> AACAGGGAAAG
AACAGGGAAAG -> ACAGGGAAAGT
ACAGGGAAAGT -> CAGGGAAAGTT
CAGGGAAAGTT -> AGGGAAAGTTT
AGGGAAAGTTT -> GGGAAAGTTTA
GGGAAAGTTTA -> GGAAAGTTTAC
GGAAAGTTTAC -> GAAAGTTTACG
GAAAGTTTACG -> AAAGTTTACGC
AAAGTTTACGC -> AAGTTTACGCC
AAGTTTACGCC -> AGTTTACGCCT
AGTTTACGCCT -> GTTTACGCCTT
GTTTACGCCTT -> TTTACGCCTTA
TTTACGCCTTA -> TTACGCCTTAT
TTACGCCTTAT -> TACGCCTTATA
TACGCCTTATA -> ACGCCTTATAG
ACGCCTTATAG -> CGCCTTATAGA
CGCCTTATAGA -> GCCTTATAGAT
GCCTTATAGAT -> CCTTATAGATC,CCTTATAGATA
CCTTATAGATC -> CTTATAGATCC
CTTATAGATCC -> TTATAGATCCT
TTATAGATCCT -> TATAGATCCTG
TATAGATCCTG -> ATAGATCCTGG
ATAGATCCTGG -> TAGATCCTGGC
TAGATCCTGGC -> AGATCCTGGCG
AGATCCTGGCG -> GATCCTGGCGG
GATCCTGGCGG -> ATCCTGGCGGA
ATCCTGGCGGA -> TCCTGGCGGAC
TCCTGGCGGAC -> CCTGGCGGACT
CCTGGCGGACT -> CTGGCGGACTA
CTGGCGGACTA -> TGGCGGACTAT
TGGCGGACTAT -> GGCGGACTATG
GGCGGACTATG -> GCGGACTATGT
GCGGACTATGT -> CGGACTATGTG
CGGACTATGTG -> GGACTATGTGC
GGACTATGTGC -> GACTATGTGCC
GACTATGTGCC -> ACTATGTGCCT
ACTATGTGCCT -> CTATGTGCCTG
CTATGTGCCTG -> TATGTGCCTGG
TATGTGCCTGG -> ATGTGCCTGGG
ATGTGCCTGGG -> TGTGCCTGGGG
TGTGCCTGGGG -> GTGCCTGGGGG
GTGCCTGGGGG -> TGCCTGGGGGG
TGCCTGGGGGG -> GCCTGGGGGGA
GCCTGGGGGGA -> CCTGGGGGGAT
CCTGGGGGGAT -> CTGGGGGGATG
CTGGGGGGATG -> TGGGGGGATGC
TGGGGGGATGC -> GGGGGGATGCG
GGGGGGATGCG -> GGGGGATGCGC
GGGGGATGCGC -> GGGGATGCGCC
GGGGATGCGCC -> GGGATGCGCCG
GGGATGCGCCG -> GGATGCGCCGT
GGATGCGCCGT -> GATGCGCCGTC
GATGCGCCGTC -> ATGCGCCGTCC
ATGCGCCGTCC -> TGCGCCGTCCA
TGCGCCGTCCA -> GCGCCGTCCAA
GCGCCGTCCAA -> CGCCGTCCAAC
CGCCGTCCAAC -> GCCGTCCAACC
GCCGTCCAACC -> CCGTCCAACCT
CCGTCCAACCT -> CGTCCAACCTC
CGTCCAACCTC -> GTCCAACCTCT
GTCCAACCTCT -> TCCAACCTCTC
TCCAACCTCTC -> CCAACCTCTCA
CCAACCTCTCA -> CAACCTCTCAA
CAACCTCTCAA -> AACCTCTCAAT
AACCTCTCAAT -> ACCTCTCAATA
ACCTCTCAATA -> CCTCTCAATAG
CCTCTCAATAG -> CTCTCAATAGC
CTCTCAATAGC -> TCTCAATAGCG
TCTCAATAGCG -> CTCAATAGCGT
CTCAATAGCGT -> TCAATAGCGTG
TCAATAGCGTG -> CAATAGCGTGG
CAATAGCGTGG -> AATAGCGTGGA
AATAGCGTGGA -> ATAGCGTGGAT
ATAGCGTGGAT -> TAGCGTGGATC
TAGCGTGGATC -> AGCGTGGATCT
AGCGTGGATCT -> GCGTGGATCTA
GCGTGGATCTA -> CGTGGATCTAA
CGTGGATCTAA -> GTGGATCTAAA
GTGGATCTAAA -> TGGATCTAAAA
TGGATCTAAAA -> GGATCTAAAAT
GGATCTAAAAT -> GATCTAAAATT
GATCTAAAATT -> ATCTAAAATTG
ATCTAAAATTG -> TCTAAAATTGT
TCTAAAATTGT -> CTAAAATTGTG
CTAAAATTGTG -> TAAAATTGTGC
TAAAATTGTGC -> AAAATTGTGCT
AAAATTGTGCT -> AAATTGTGCTT
AAATTGTGCTT -> AATTGTGCTTC
AATTGTGCTTC -> ATTGTGCTTCC
ATTGTGCTTCC -> TTGTGCTTCCG
TTGTGCTTCCG -> TGTGCTTCCGC
TGTGCTTCCGC -> GTGCTTCCGCG
GTGCTTCCGCG -> TGCTTCCGCGC
TGCTTCCGCGC -> GCTTCCGCGCC
GCTTCCGCGCC -> CTTCCGCGCCG
CTTCCGCGCCG -> TTCCGCGCCGC
TTCCGCGCCGC -> TCCGCGCCGCG
TCCGCGCCGCG -> CCGCGCCGCGA
CCGCGCCGCGA -> CGCGCCGCGAC
CGCGCCGCGAC -> GCGCCGCGACT
GCGCCGCGACT -> CGCCGCGACTT
CGCCGCGACTT -> GCCGCGACTTG
GCCGCGACTTG -> CCGCGACTTGT
CCGCGACTTGT -> CGCGACTTGTG
CGCGACTTGTG -> GCGACTTGTGG
GCGACTTGTGG -> CGACTTGTGGC
CGACTTGTGGC -> GACTTGTGGCA
GACTTGTGGCA -> ACTTGTGGCAA
ACTTGTGGCAA -> CTTGTGGCAAG
CTTGTGGCAAG -> TTGTGGCAAGA
TTGTGGCAAGA -> TGTGGCAAGAC
TGTGGCAAGAC -> GTGGCAAGACC
GTGGCAAGACC -> TGGCAAGACCA
TGGCAAGACCA -> GGCAAGACCAC
GGCAAGACCAC -> GCAAGACCACG
GCAAGACCACG -> CAAGACCACGT
CAAGACCACGT -> AAGACCACGTT
AAGACCACGTT -> AGACCACGTTG
AGACCACGTTG -> GACCACGTTGT
GACCACGTTGT -> ACCACGTTGTC
ACCACGTTGTC -> CCACGTTGTCC
CCACGTTGTCC -> CACGTTGTCCA
CACGTTGTCCA -> ACGTTGTCCAC
ACGTTGTCCAC -> CGTTGTCCACC
CGTTGTCCACC -> GTTGTCCACCG
GTTGTCCACCG -> TTGTCCACCGG
TTGTCCACCGG -> TGTCCACCGGA
TGTCCACCGGA -> GTCCACCGGAA
GTCCACCGGAA -> TCCACCGGAAC
TCCACCGGAAC -> CCACCGGAACT
CCACCGGAACT -> CACCGGAACTG
CACCGGAACTG -> ACCGGAACTGA
ACCGGAACTGA -> CCGGAACTGAA
CCGGAACTGAA -> CGGAACTGAAG
CGGAACTGAAG -> GGAACTGAAGA
GGAACTGAAGA -> GAACTGAAGAT
GAACTGAAGAT -> AACTGAAGATG
AACTGAAGATG -> ACTGAAGATGT
ACTGAAGATGT -> CTGAAGATGTG
CTGAAGATGTG -> TGAAGATGTGT
TGAAGATGTGT -> GAAGATGTGTT
GAAGATGTGTT -> AAGATGTGTTA
AAGATGTGTTA -> AGATGTGTTAT
AGATGTGTTAT -> GATGTGTTATG
GATGTGTTATG -> ATGTGTTATGT
ATGTGTTATGT -> TGTGTTATGTT
TGTGTTATGTT -> GTGTTATGTTG
GTGTTATGTTG -> TGTTATGTTGT
TGTTATGTTGT -> GTTATGTTGTA
GTTATGTTGTA -> TTATGTTGTAA
TTATGTTGTAA -> TATGTTGTAAA
TATGTTGTAAA -> ATGTTGTAAAG
ATGTTGTAAAG -> TGTTGTAAAGT
TGTTGTAAAGT -> GTTGTAAAGTT
GTTGTAAAGTT -> TTGTAAAGTTG
TTGTAAAGTTG -> TGTAAAGTTGG
TGTAAAGTTGG -> GTAAAGTTGGT
GTAAAGTTGGT -> TAAAGTTGGTG
TAAAGTTGGTG -> AAAGTTGGTGA
AAAGTTGGTGA -> AAGTTGGTGAG
AAGTTGGTGAG -> AGTTGGTGAGG
AGTTGGTGAGG -> GTTGGTGAGGG
GTTGGTGAGGG -> TTGGTGAGGGC
TTGGTGAGGGC -> TGGTGAGGGCT
TGGTGAGGGCT -> GGTGAGGGCTG
GGTGAGGGCTG -> GTGAGGGCTGC
GTGAGGGCTGC -> TGAGGGCTGCC
TGAGGGCTGCC -> GAGGGCTGCCT
GAGGGCTGCCT -> AGGGCTGCCTT
AGGGCTGCCTT -> GGGCTGCCTTG
GGGCTGCCTTG -> GGCTGCCTTGG
GGCTGCCTTGG -> GCTGCCTTGGA
GCTGCCTTGGA -> CTGCCTTGGAA
CTGCCTTGGAA -> TGCCTTGGAAC
TGCCTTGGAAC -> GCCTTGGAACT
GCCTTGGAACT -> CCTTGGAACTT
CCTTGGAACTT -> CTTGGAACTTA
CTTGGAACTTA -> TTGGAACTTAG
TTGGAACTTAG -> TGGAACTTAGT
TGGAACTTAGT -> GGAACTTAGTT
GGAACTTAGTT -> GAACTTAGTTT
GAACTTAGTTT -> AACTTAGTTTC
AACTTAGTTTC -> ACTTAGTTTCG
ACTTAGTTTCG -> CTTAGTTTCGT
CTTAGTTTCGT -> TTAGTTTCGTA
TTAGTTTCGTA -> TAGTTTCGTAA
TAGTTTCGTAA -> AGTTTCGTAAC
AGTTTCGTAAC -> GTTTCGTAACA
GTTTCGTAACA -> TTTCGTAACAA
TTTCGTAACAA -> TTCGTAACAAC
TTCGTAACAAC -> TCGTAACAACT
TCGTAACAACT -> CGTAACAACTG
CGTAACAACTG -> GTAACAACTGT
GTAACAACTGT -> TAACAACTGTT
TAACAACTGTT -> AACAACTGTTC
AACAACTGTTC -> ACAACTGTTCA
ACAACTGTTCA -> CAACTGTTCAC
CAACTGTTCAC -> AACTGTTCACT
AACTGTTCACT -> ACTGTTCACTT
ACTGTTCACTT -> CTGTTCACTTC
CTGTTCACTTC -> TGTTCACTTCT
TGTTCACTTCT -> GTTCACTTCTT
GTTCACTTCTT -> TTCACTTCTTA
TTCACTTCTTA -> TCACTTCTTAG
TCACTTCTTAG -> CACTTCTTAGG
CACTTCTTAGG -> ACTTCTTAGGT
ACTTCTTAGGT -> CTTCTTAGGTC
CTTCTTAGGTC -> TTCTTAGGTCC
TTCTTAGGTCC -> TCTTAGGTCCT
TCTTAGGTCCT -> CTTAGGTCCTA
CTTAGGTCCTA -> TTAGGTCCTAA
TTAGGTCCTAA -> TAGGTCCTAAC
TAGGTCCTAAC -> AGGTCCTAACA
AGGTCCTAACA -> GGTCCTAACAT
GGTCCTAACAT -> GTCCTAACATC
GTCCTAACATC -> TCCTAACATCC
TCCTAACATCC -> CCTAACATCCC
CCTAACATCCC -> CTAACATCCCA
CTAACATCCCA -> TAACATCCCAT
TAACATCCCAT -> AACATCCCATC
AACATCCCATC -> ACATCCCATCA
ACATCCCATCA -> CATCCCATCAA
CATCCCATCAA -> ATCCCATCAAA
ATCCCATCAAA -> TCCCATCAAAT
TCCCATCAAAT -> CCCATCAAATA
CCCATCAAATA -> CCATCAAATAG
CCATCAAATAG -> CATCAAATAGA
CATCAAATAGA -> ATCAAATAGAC
ATCAAATAGAC -> TCAAATAGACA
TCAAATAGACA -> CAAATAGACAC
CAAATAGACAC -> AAATAGACACA
AAATAGACACA -> AATAGACACAT
AATAGACACAT -> ATAGACACATC
ATAGACACATC -> TAGACACATCG
TAGACACATCG -> AGACACATCGA
AGACACATCGA -> GACACATCGAC
GACACATCGAC -> ACACATCGACT
ACACATCGACT -> CACATCGACTA
CACATCGACTA -> ACATCGACTAC
ACATCGACTAC -> CATCGACTACC
CATCGACTACC -> ATCGACTACCT
ATCGACTACCT -> TCGACTACCTC
TCGACTACCTC -> CGACTACCTCG
CGACTACCTCG -> GACTACCTCGA
GACTACCTCGA -> ACTACCTCGAG
ACTACCTCGAG -> CTACCTCGAGA
CTACCTCGAGA -> TACCTCGAGAC
TACCTCGAGAC -> ACCTCGAGACT
ACCTCGAGACT -> CCTCGAGACTC
CCTCGAGACTC -> CTCGAGACTCG
CTCGAGACTCG -> TCGAGACTCGC
TCGAGACTCGC -> CGAGACTCGCT
CGAGACTCGCT -> GAGACTCGCTC
GAGACTCGCTC -> AGACTCGCTCG
AGACTCGCTCG -> GACTCGCTCGA
GACTCGCTCGA -> ACTCGCTCGAA
ACTCGCTCGAA -> CTCGCTCGAAT
CTCGCTCGAAT -> TCGCTCGAATT
TCGCTCGAATT -> CGCTCGAATTA
CGCTCGAATTA -> GCTCGAATTAA
GCTCGAATTAA -> CTCGAATTAAA
CTCGAATTAAA -> TCGAATTAAAC
TCGAATTAAAC -> CGAATTAAACG
CGAATTAAACG -> GAATTAAACGA
GAATTAAACGA -> AATTAAACGAT
AATTAAACGAT -> ATTAAACGATC
ATTAAACGATC -> TTAAACGATCA
TTAAACGATCA -> TAAACGATCAA
TAAACGATCAA -> AAACGATCAAG
AAACGATCAAG -> AACGATCAAGA
AACGATCAAGA -> ACGATCAAGAC
ACGATCAAGAC -> CGATCAAGACT
CGATCAAGACT -> GATCAAGACTA
GATCAAGACTA -> ATCAAGACTAC
ATCAAGACTAC -> TCAAGACTACG
TCAAGACTACG -> CAAGACTACGC
CAAGACTACGC -> AAGACTACGCC
AAGACTACGCC -> AGACTACGCCT
AGACTACGCCT -> GACTACGCCTT
GACTACGCCTT -> ACTACGCCTTG
ACTACGCCTTG -> CTACGCCTTGT
CTACGCCTTGT -> TACGCCTTGTG
TACGCCTTGTG -> ACGCCTTGTGG
ACGCCTTGTGG -> CGCCTTGTGGC
CGCCTTGTGGC -> GCCTTGTGGCC
GCCTTGTGGCC -> CCTTGTGGCCT
CCTTGTGGCCT -> CTTGTGGCCTT
CTTGTGGCCTT -> TTGTGGCCTTC
TTGTGGCCTTC -> TGTGGCCTTCA
TGTGGCCTTCA -> GTGGCCTTCAT
GTGGCCTTCAT -> TGGCCTTCATG
TGGCCTTCATG -> GGCCTTCATGA
GGCCTTCATGA -> GCCTTCATGAA
GCCTTCATGAA -> CCTTCATGAAA
CCTTCATGAAA -> CTTCATGAAAA
CTTCATGAAAA -> TTCATGAAAAA
TTCATGAAAAA -> TCATGAAAAAG
TCATGAAAAAG -> CATGAAAAAGT
CATGAAAAAGT -> ATGAAAAAGTC
ATGAAAAAGTC -> TGAAAAAGTCC
TGAAAAAGTCC -> GAAAAAGTCCC
GAAAAAGTCCC -> AAAAAGTCCCC
AAAAAGTCCCC -> AAAAGTCCCCG
AAAAGTCCCCG -> AAAGTCCCCGT
AAAGTCCCCGT -> AAGTCCCCGTG
AAGTCCCCGTG -> AGTCCCCGTGG
AGTCCCCGTGG -> GTCCCCGTGGT
GTCCCCGTGGT -> TCCCCGTGGTG
TCCCCGTGGTG -> CCCCGTGGTGC
CCCCGTGGTGC -> CCCGTGGTGCT
CCCGTGGTGCT -> CCGTGGTGCTT
CCGTGGTGCTT -> CGTGGTGCTTA
CGTGGTGCTTA -> GTGGTGCTTAG
GTGGTGCTTAG -> TGGTGCTTAGA
TGGTGCTTAGA -> GGTGCTTAGAT
GGTGCTTAGAT -> GTGCTTAGATT
GTGCTTAGATT -> TGCTTAGATTG
TGCTTAGATTG -> GCTTAGATTGG
GCTTAGATTGG -> CTTAGATTGGC
CTTAGATTGGC -> TTAGATTGGCG
TTAGATTGGCG -> TAGATTGGCGA
TAGATTGGCGA -> AGATTGGCGAT
AGATTGGCGAT -> GATTGGCGATT
GATTGGCGATT -> ATTGGCGATTT
ATTGGCGATTT -> TTGGCGATTTA
TTGGCGATTTA -> TGGCGATTTAT
TGGCGATTTAT -> GGCGATTTATC
GGCGATTTATC -> GCGATTTATCC
GCGATTTATCC -> CGATTTATCCG
CGATTTATCCG -> GATTTATCCGA
GATTTATCCGA -> ATTTATCCGAC
ATTTATCCGAC -> TTTATCCGACG
TTTATCCGACG -> TTATCCGACGC
TTATCCGACGC -> TATCCGACGCT
TATCCGACGCT -> ATCCGACGCTT
ATCCGACGCTT -> TCCGACGCTTA
TCCGACGCTTA -> CCGACGCTTAA
CCGACGCTTAA -> CGACGCTTAAT
CGACGCTTAAT -> GACGCTTAATG
GACGCTTAATG -> ACGCTTAATGA
ACGCTTAATGA -> CGCTTAATGAA
CGCTTAATGAA -> GCTTAATGAAA
GCTTAATGAAA -> CTTAATGAAAG
CTTAATGAAAG -> TTAATGAAAGG
TTAATGAAAGG -> TAATGAAAGGA
TAATGAAAGGA -> AATGAAAGGAC
AATGAAAGGAC -> ATGAAAGGACG
ATGAAAGGACG -> TGAAAGGACGT
TGAAAGGACGT -> GAAAGGACGTG
GAAAGGACGTG -> AAAGGACGTGT
AAAGGACGTGT -> AAGGACGTGTG
AAGGACGTGTG -> AGGACGTGTGC
AGGACGTGTGC -> GGACGTGTGCA
GGACGTGTGCA -> GACGTGTGCAG
GACGTGTGCAG -> ACGTGTGCAGT
ACGTGTGCAGT -> CGTGTGCAGTA
CGTGTGCAGTA -> GTGTGCAGTAT
GTGTGCAGTAT -> TGTGCAGTATG
TGTGCAGTATG -> GTGCAGTATGC
GTGCAGTATGC -> TGCAGTATGCA
TGCAGTATGCA -> GCAGTATGCAT
GCAGTATGCAT -> CAGTATGCATT
CAGTATGCATT -> AGTATGCATTA
AGTATGCATTA -> GTATGCATTAC
GTATGCATTAC -> TATGCATTACG
TATGCATTACG -> ATGCATTACGC
ATGCATTACGC -> TGCATTACGCT
TGCATTACGCT -> GCATTACGCTA
GCATTACGCTA -> CATTACGCTAA
CATTACGCTAA -> ATTACGCTAAT
ATTACGCTAAT -> TTACGCTAATC
TTACGCTAATC -> TACGCTAATCA
TACGCTAATCA -> ACGCTAATCAT
ACGCTAATCAT -> CGCTAATCATG
CGCTAATCATG -> GCTAATCATGG
GCTAATCATGG -> CTAATCATGGG
CTAATCATGGG -> TAATCATGGGC
TAATCATGGGC -> AATCATGGGCC
AATCATGGGCC -> ATCATGGGCCG
ATCATGGGCCG -> TCATGGGCCGT
TCATGGGCCGT -> CATGGGCCGTT
CATGGGCCGTT -> ATGGGCCGTTC
ATGGGCCGTTC -> TGGGCCGTTCA
TGGGCCGTTCA -> GGGCCGTTCAG
GGGCCGTTCAG -> GGCCGTTCAGT
GGCCGTTCAGT -> GCCGTTCAGTC
GCCGTTCAGTC -> CCGTTCAGTCA
CCGTTCAGTCA -> CGTTCAGTCAA
CGTTCAGTCAA -> GTTCAGTCAAC
GTTCAGTCAAC -> TTCAGTCAACC
TTCAGTCAACC -> TCAGTCAACCG
TCAGTCAACCG -> CAGTCAACCGA
CAGTCAACCGA -> AGTCAACCGAT
AGTCAACCGAT -> GTCAACCGATC
GTCAACCGATC -> TCAACCGATCT
TCAACCGATCT -> CAACCGATCTG
CAACCGATCTG -> AACCGATCTGG
AACCGATCTGG -> ACCGATCTGGT
ACCGATCTGGT -> CCGATCTGGTC
CCGATCTGGTC -> CGATCTGGTCC
CGATCTGGTCC -> GATCTGGTCCG
GATCTGGTCCG -> ATCTGGTCCGG
ATCTGGTCCGG -> TCTGGTCCGGC
TCTGGTCCGGC -> CTGGTCCGGCC
CTGGTCCGGCC -> TGGTCCGGCCA
TGGTCCGGCCA -> GGTCCGGCCAT
GGTCCGGCCAT -> GTCCGGCCATG
GTCCGGCCATG -> TCCGGCCATGT
TCCGGCCATGT -> CCGGCCATGTA
CCGGCCATGTA -> CGGCCATGTAA
CGGCCATGTAA -> GGCCATGTAAT
GGCCATGTAAT -> GCCATGTAATA
GCCATGTAATA -> CCATGTAATAT
CCATGTAATAT -> CATGTAATATC
CATGTAATATC -> ATGTAATATCT
ATGTAATATCT -> TGTAATATCTT
TGTAATATCTT -> GTAATATCTTA
GTAATATCTTA -> TAATATCTTAA
TAATATCTTAA -> AATATCTTAAG
AATATCTTAAG -> ATATCTTAAGT
ATATCTTAAGT -> TATCTTAAGTG
TATCTTAAGTG -> ATCTTAAGTGA
ATCTTAAGTGA -> TCTTAAGTGAA
TCTTAAGTGAA -> CTTAAGTGAAC
CTTAAGTGAAC -> TTAAGTGAACC
TTAAGTGAACC -> TAAGTGAACCA
TAAGTGAACCA -> AAGTGAACCAT
AAGTGAACCAT -> AGTGAACCATA
AGTGAACCATA -> GTGAACCATAG
GTGAACCATAG -> TGAACCATAGA
TGAACCATAGA -> GAACCATAGAC
GAACCATAGAC -> AACCATAGACA
AACCATAGACA -> ACCATAGACAA
ACCATAGACAA -> CCATAGACAAA
CCATAGACAAA -> CATAGACAAAG
CATAGACAAAG -> ATAGACAAAGA
ATAGACAAAGA -> TAGACAAAGAA
TAGACAAAGAA -> AGACAAAGAAC
AGACAAAGAAC -> GACAAAGAACC
GACAAAGAACC -> ACAAAGAACCG
ACAAAGAACCG -> CAAAGAACCGT
CAAAGAACCGT -> AAAGAACCGTA
AAAGAACCGTA -> AAGAACCGTAA
AAGAACCGTAA -> AGAACCGTAAG
AGAACCGTAAG -> GAACCGTAAGA
GAACCGTAAGA -> AACCGTAAGAC
AACCGTAAGAC -> ACCGTAAGACA
ACCGTAAGACA -> CCGTAAGACAA
CCGTAAGACAA -> CGTAAGACAAG
CGTAAGACAAG -> GTAAGACAAGA
GTAAGACAAGA -> TAAGACAAGAC
TAAGACAAGAC -> AAGACAAGACT
AAGACAAGACT -> AGACAAGACTA
AGACAAGACTA -> GACAAGACTAA
GACAAGACTAA -> ACAAGACTAAA
ACAAGACTAAA -> CAAGACTAAAT
CAAGACTAAAT -> AAGACTAAATC
AAGACTAAATC -> AGACTAAATCA
AGACTAAATCA -> GACTAAATCAG
GACTAAATCAG -> ACTAAATCAGT
ACTAAATCAGT -> CTAAATCAGTG
CTAAATCAGTG -> TAAATCAGTGC
TAAATCAGTGC -> AAATCAGTGCG
AAATCAGTGCG -> AATCAGTGCGG
AATCAGTGCGG -> ATCAGTGCGGC
ATCAGTGCGGC -> TCAGTGCGGCC
TCAGTGCGGCC -> CAGTGCGGCCT
CAGTGCGGCCT -> AGTGCGGCCTA
AGTGCGGCCTA -> GTGCGGCCTAC
GTGCGGCCTAC -> TGCGGCCTACT
TGCGGCCTACT -> GCGGCCTACTC
GCGGCCTACTC -> CGGCCTACTCG
CGGCCTACTCG -> GGCCTACTCGA
GGCCTACTCGA -> GCCTACTCGAA
GCCTACTCGAA -> CCTACTCGAAG
CCTACTCGAAG -> CTACTCGAAGA
CTACTCGAAGA -> TACTCGAAGAG
TACTCGAAGAG -> ACTCGAAGAGA
ACTCGAAGAGA -> CTCGAAGAGAG
CTCGAAGAGAG -> TCGAAGAGAGC
TCGAAGAGAGC -> CGAAGAGAGCC
CGAAGAGAGCC -> GAAGAGAGCCA
GAAGAGAGCCA -> AAGAGAGCCAG
AAGAGAGCCAG -> AGAGAGCCAGA
AGAGAGCCAGA -> GAGAGCCAGAA
GAGAGCCAGAA -> AGAGCCAGAAC
AGAGCCAGAAC -> GAGCCAGAACG
GAGCCAGAACG -> AGCCAGAACGT
AGCCAGAACGT -> GCCAGAACGTA
GCCAGAACGTA -> CCAGAACGTAT
CCAGAACGTAT -> CAGAACGTATA
CAGAACGTATA -> AGAACGTATAA
AGAACGTATAA -> GAACGTATAAT
GAACGTATAAT -> AACGTATAATG
AACGTATAATG -> ACGTATAATGC
ACGTATAATGC -> CGTATAATGCG
CGTATAATGCG -> GTATAATGCGT
GTATAATGCGT -> TATAATGCGTA
TATAATGCGTA -> ATAATGCGTAA
ATAATGCGTAA -> TAATGCGTAAC
TAATGCGTAAC -> AATGCGTAACA
AATGCGTAACA -> ATGCGTAACAC
ATGCGTAACAC -> TGCGTAACACT
TGCGTAACACT -> GCGTAACACTG
GCGTAACACTG -> CGTAACACTGG
CGTAACACTGG -> GTAACACTGGC
GTAACACTGGC -> TAACACTGGCC
TAACACTGGCC -> AACACTGGCCG
AACACTGGCCG -> ACACTGGCCGA
ACACTGGCCGA -> CACTGGCCGAT
CACTGGCCGAT -> ACTGGCCGATA
ACTGGCCGATA -> CTGGCCGATAC
CTGGCCGATAC -> TGGCCGATACC
TGGCCGATACC -> GGCCGATACCT
GGCCGATACCT -> GCCGATACCTT
GCCGATACCTT -> CCGATACCTTC
CCGATACCTTC -> CGATACCTTCC
CGATACCTTCC -> GATACCTTCCG
GATACCTTCCG -> ATACCTTCCGT
ATACCTTCCGT -> TACCTTCCGTT
TACCTTCCGTT -> ACCTTCCGTTC
ACCTTCCGTTC -> CCTTCCGTTCG
CCTTCCGTTCG -> CTTCCGTTCGA
CTTCCGTTCGA -> TTCCGTTCGAT
TTCCGTTCGAT -> TCCGTTCGATA
TCCGTTCGATA -> CCGTTCGATAC
CCGTTCGATAC -> CGTTCGATACG
CGTTCGATACG -> GTTCGATACGA
GTTCGATACGA -> TTCGATACGAA
TTCGATACGAA -> TCGATACGAAT
TCGATACGAAT -> CGATACGAATG
CGATACGAATG -> GATACGAATGG
GATACGAATGG -> ATACGAATGGC
ATACGAATGGC -> TACGAATGGCG
TACGAATGGCG -> ACGAATGGCGA
ACGAATGGCGA -> CGAATGGCGAC
CGAATGGCGAC -> GAATGGCGACT
GAATGGCGACT -> AATGGCGACTT
AATGGCGACTT -> ATGGCGACTTA
ATGGCGACTTA -> TGGCGACTTAT
TGGCGACTTAT -> GGCGACTTATG
GGCGACTTATG -> GCGACTTATGA
GCGACTTATGA -> CGACTTATGAA
CGACTTATGAA -> GACTTATGAAC
GACTTATGAAC -> ACTTATGAACT
ACTTATGAACT -> CTTATGAACTT
CTTATGAACTT -> TTATGAACTTT
TTATGAACTTT -> TATGAACTTTG
TATGAACTTTG -> ATGAACTTTGG
ATGAACTTTGG -> TGAACTTTGGC
TGAACTTTGGC -> GAACTTTGGCA
GAACTTTGGCA -> AACTTTGGCAG
AACTTTGGCAG -> ACTTTGGCAGT
ACTTTGGCAGT -> CTTTGGCAGTA
CTTTGGCAGTA -> TTTGGCAGTAG
TTTGGCAGTAG -> TTGGCAGTAGA
TTGGCAGTAGA -> TGGCAGTAGAA
TGGCAGTAGAA -> GGCAGTAGAAC
GGCAGTAGAAC -> GCAGTAGAACT
GCAGTAGAACT -> CAGTAGAACTG
CAGTAGAACTG -> AGTAGAACTGT
AGTAGAACTGT -> GTAGAACTGTT
GTAGAACTGTT -> TAGAACTGTTT
TAGAACTGTTT -> AGAACTGTTTT
AGAACTGTTTT -> GAACTGTTTTA
GAACTGTTTTA -> AACTGTTTTAT
AACTGTTTTAT -> ACTGTTTTATG
ACTGTTTTATG -> CTGTTTTATGA
CTGTTTTATGA -> TGTTTTATGAT
TGTTTTATGAT -> GTTTTATGATC
GTTTTATGATC -> TTTTATGATCG
TTTTATGATCG -> TTTATGATCGG
TTTATGATCGG -> TTATGATCGGT
TTATGATCGGT -> TATGATCGGTG
TATGATCGGTG -> ATGATCGGTGT
ATGATCGGTGT -> TGATCGGTGTT
TGATCGGTGTT -> GATCGGTGTTG
GATCGGTGTTG -> ATCGGTGTTGA
ATCGGTGTTGA -> TCGGTGTTGAT
TCGGTGTTGAT -> CGGTGTTGATC
CGGTGTTGATC -> GGTGTTGATCA
GGTGTTGATCA -> GTGTTGATCAG
GTGTTGATCAG -> TGTTGATCAGT
TGTTGATCAGT -> GTTGATCAGTT
GTTGATCAGTT -> TTGATCAGTTT
TTGATCAGTTT -> TGATCAGTTTC
TGATCAGTTTC -> GATCAGTTTCG
GATCAGTTTCG -> ATCAGTTTCGA
ATCAGTTTCGA -> TCAGTTTCGAG
TCAGTTTCGAG -> CAGTTTCGAGC
CAGTTTCGAGC -> AGTTTCGAGCT
AGTTTCGAGCT -> GTTTCGAGCTT
GTTTCGAGCTT -> TTTCGAGCTTG
TTTCGAGCTTG -> TTCGAGCTTGA
TTCGAGCTTGA -> TCGAGCTTGAA
TCGAGCTTGAA -> CGAGCTTGAAA
CGAGCTTGAAA -> GAGCTTGAAAG
GAGCTTGAAAG -> AGCTTGAAAGG
AGCTTGAAAGG -> GCTTGAAAGGG
GCTTGAAAGGG -> CTTGAAAGGGG
CTTGAAAGGGG -> TTGAAAGGGGG
TTGAAAGGGGG -> TGAAAGGGGGG
TGAAAGGGGGG -> GAAAGGGGGGT
GAAAGGGGGGT -> AAAGGGGGGTC
AAAGGGGGGTC -> AAGGGGGGTCT
AAGGGGGGTCT -> AGGGGGGTCTG
AGGGGGGTCTG -> GGGGGGTCTGC
GGGGGGTCTGC -> GGGGGTCTGCC
GGGGGTCTGCC -> GGGGTCTGCCC
GGGGTCTGCCC -> GGGTCTGCCCC
GGGTCTGCCCC -> GGTCTGCCCCC
GGTCTGCCCCC -> GTCTGCCCCCT
GTCTGCCCCCT -> TCTGCCCCCTC
TCTGCCCCCTC -> CTGCCCCCTCT
CTGCCCCCTCT -> TGCCCCCTCTC
TGCCCCCTCTC -> GCCCCCTCTCC
GCCCCCTCTCC -> CCCCCTCTCCT
CCCCCTCTCCT -> CCCCTCTCCTG
CCCCTCTCCTG -> CCCTCTCCTGA
CCCTCTCCTGA -> CCTCTCCTGAA
CCTCTCCTGAA -> CTCTCCTGAAT
CTCTCCTGAAT -> TCTCCTGAATT
TCTCCTGAATT -> CTCCTGAATTT
CTCCTGAATTT -> TCCTGAATTTA
TCCTGAATTTA -> CCTGAATTTAC
CCTGAATTTAC -> CTGAATTTACA
CTGAATTTACA -> TGAATTTACAT
TGAATTTACAT -> GAATTTACATA
GAATTTACATA -> AATTTACATAG
AATTTACATAG -> ATTTACATAGA
ATTTACATAGA -> TTTACATAGAC
TTTACATAGAC -> TTACATAGACT
TTACATAGACT -> TACATAGACTG
TACATAGACTG -> ACATAGACTGA
ACATAGACTGA -> CATAGACTGAT
CATAGACTGAT -> ATAGACTGATC
ATAGACTGATC -> TAGACTGATCG
TAGACTGATCG -> AGACTGATCGT
AGACTGATCGT -> GACTGATCGTA
GACTGATCGTA -> ACTGATCGTAG
ACTGATCGTAG -> CTGATCGTAGG
CTGATCGTAGG -> TGATCGTAGGT
TGATCGTAGGT -> GATCGTAGGTC
GATCGTAGGTC -> ATCGTAGGTCA
ATCGTAGGTCA -> TCGTAGGTCAG
TCGTAGGTCAG -> CGTAGGTCAGA
CGTAGGTCAGA -> GTAGGTCAGAG
GTAGGTCAGAG -> TAGGTCAGAGG
TAGGTCAGAGG -> AGGTCAGAGGT
AGGTCAGAGGT -> GGTCAGAGGTC
GGTCAGAGGTC -> GTCAGAGGTCT
GTCAGAGGTCT -> TCAGAGGTCTA
TCAGAGGTCTA -> CAGAGGTCTAC
CAGAGGTCTAC -> AGAGGTCTACA
AGAGGTCTACA -> GAGGTCTACAC
GAGGTCTACAC -> AGGTCTACACG
AGGTCTACACG -> GGTCTACACGG
GGTCTACACGG -> GTCTACACGGC
GTCTACACGGC -> TCTACACGGCT
TCTACACGGCT -> CTACACGGCTC
CTACACGGCTC -> TACACGGCTCG
TACACGGCTCG -> ACACGGCTCGA
ACACGGCTCGA -> CACGGCTCGAT
CACGGCTCGAT -> ACGGCTCGATG
ACGGCTCGATG -> CGGCTCGATGT
CGGCTCGATGT -> GGCTCGATGTC
GGCTCGATGTC -> GCTCGATGTCA
GCTCGATGTCA -> CTCGATGTCAA
CTCGATGTCAA -> TCGATGTCAAT
TCGATGTCAAT -> CGATGTCAATT
CGATGTCAATT -> GATGTCAATTA
GATGTCAATTA -> ATGTCAATTAT
ATGTCAATTAT -> TGTCAATTATC
TGTCAATTATC -> GTCAATTATCG
GTCAATTATCG -> TCAATTATCGC
TCAATTATCGC -> CAATTATCGCA
CAATTATCGCA -> AATTATCGCAC
AATTATCGCAC -> ATTATCGCACC
ATTATCGCACC -> TTATCGCACCC
TTATCGCACCC -> TATCGCACCCA
TATCGCACCCA -> ATCGCACCCAT
ATCGCACCCAT -> TCGCACCCATA
TCGCACCCATA -> CGCACCCATAC
CGCACCCATAC -> GCACCCATACT
GCACCCATACT -> CACCCATACTT
CACCCATACTT -> ACCCATACTTC
ACCCATACTTC -> CCCATACTTCT
CCCATACTTCT -> CCATACTTCTA
CCATACTTCTA -> CATACTTCTAC
CATACTTCTAC -> ATACTTCTACA
ATACTTCTACA -> TACTTCTACAC
TACTTCTACAC -> ACTTCTACACA
ACTTCTACACA -> CTTCTACACAC
CTTCTACACAC -> TTCTACACACG
TTCTACACACG -> TCTACACACGC
TCTACACACGC -> CTACACACGCA
CTACACACGCA -> TACACACGCAA
TACACACGCAA -> ACACACGCAAC
ACACACGCAAC -> CACACGCAACT
CACACGCAACT -> ACACGCAACTG
ACACGCAACTG -> CACGCAACTGC
CACGCAACTGC -> ACGCAACTGCT
ACGCAACTGCT -> CGCAACTGCTT
CGCAACTGCTT -> GCAACTGCTTT
GCAACTGCTTT -> CAACTGCTTTT
CAACTGCTTTT -> AACTGCTTTTA
AACTGCTTTTA -> ACTGCTTTTAC
ACTGCTTTTAC -> CTGCTTTTACA
CTGCTTTTACA -> TGCTTTTACAG
TGCTTTTACAG -> GCTTTTACAGA
GCTTTTACAGA -> CTTTTACAGAT
CTTTTACAGAT -> TTTTACAGATA
TTTTACAGATA -> TTTACAGATAT
TTTACAGATAT -> TTACAGATATT
TTACAGATATT -> TACAGATATTG
TACAGATATTG -> ACAGATATTGT
ACAGATATTGT -> CAGATATTGTA
CAGATATTGTA -> AGATATTGTAA
AGATATTGTAA -> GATATTGTAAG
GATATTGTAAG -> ATATTGTAAGC
ATATTGTAAGC -> TATTGTAAGCG
TATTGTAAGCG -> ATTGTAAGCGG
ATTGTAAGCGG -> TTGTAAGCGGC
TTGTAAGCGGC -> TGTAAGCGGCC
TGTAAGCGGCC -> GTAAGCGGCCG
GTAAGCGGCCG -> TAAGCGGCCGG
TAAGCGGCCGG -> AAGCGGCCGGA
AAGCGGCCGGA -> AGCGGCCGGAG
AGCGGCCGGAG -> GCGGCCGGAGT
GCGGCCGGAGT -> CGGCCGGAGTG
CGGCCGGAGTG -> GGCCGGAGTGC
GGCCGGAGTGC -> GCCGGAGTGCA
GCCGGAGTGCA -> CCGGAGTGCAA
CCGGAGTGCAA -> CGGAGTGCAAG
CGGAGTGCAAG -> GGAGTGCAAGC
GGAGTGCAAGC -> GAGTGCAAGCC
GAGTGCAAGCC -> AGTGCAAGCCA
AGTGCAAGCCA -> GTGCAAGCCAT
GTGCAAGCCAT -> TGCAAGCCATA
TGCAAGCCATA -> GCAAGCCATAG
GCAAGCCATAG -> CAAGCCATAGA
CAAGCCATAGA -> AAGCCATAGAT
AAGCCATAGAT -> AGCCATAGATG
AGCCATAGATG -> GCCATAGATGG
GCCATAGATGG -> CCATAGATGGA
CCATAGATGGA -> CATAGATGGAG
CATAGATGGAG -> ATAGATGGAGA
ATAGATGGAGA -> TAGATGGAGAT
TAGATGGAGAT -> AGATGGAGATC
AGATGGAGATC -> GATGGAGATCC
GATGGAGATCC -> ATGGAGATCCA
ATGGAGATCCA -> TGGAGATCCAC
TGGAGATCCAC -> GGAGATCCACA
GGAGATCCACA -> GAGATCCACAG
GAGATCCACAG -> AGATCCACAGC
AGATCCACAGC -> GATCCACAGCC
GATCCACAGCC -> ATCCACAGCCG
ATCCACAGCCG -> TCCACAGCCGA
TCCACAGCCGA -> CCACAGCCGAC
CCACAGCCGAC -> CACAGCCGACC
CACAGCCGACC -> ACAGCCGACCT
ACAGCCGACCT -> CAGCCGACCTC
CAGCCGACCTC -> AGCCGACCTCA
AGCCGACCTCA -> GCCGACCTCAC
GCCGACCTCAC -> CCGACCTCACA
CCGACCTCACA -> CGACCTCACAA
CGACCTCACAA -> GACCTCACAAC
GACCTCACAAC -> ACCTCACAACA
ACCTCACAACA -> CCTCACAACAT
CCTCACAACAT -> CTCACAACATA
CTCACAACATA -> TCACAACATAA
TCACAACATAA -> CACAACATAAT
CACAACATAAT -> ACAACATAATA
ACAACATAATA -> CAACATAATAC
CAACATAATAC -> AACATAATACG
AACATAATACG -> ACATAATACGG
ACATAATACGG -> CATAATACGGC
CATAATACGGC -> ATAATACGGCC
ATAATACGGCC -> TAATACGGCCT
TAATACGGCCT -> AATACGGCCTT
AATACGGCCTT -> ATACGGCCTTG
ATACGGCCTTG -> TACGGCCTTGG
TACGGCCTTGG -> ACGGCCTTGGG
ACGGCCTTGGG -> CGGCCTTGGGT
CGGCCTTGGGT -> GGCCTTGGGTC
GGCCTTGGGTC -> GCCTTGGGTCC
GCCTTGGGTCC -> CCTTGGGTCCA
CCTTGGGTCCA -> CTTGGGTCCAC
CTTGGGTCCAC -> TTGGGTCCACA
TTGGGTCCACA -> TGGGTCCACAC
TGGGTCCACAC -> GGGTCCACACT
GGGTCCACACT -> GGTCCACACTC
GGTCCACACTC -> GTCCACACTCT
GTCCACACTCT -> TCCACACTCTG
TCCACACTCTG -> CCACACTCTGG
CCACACTCTGG -> CACACTCTGGA
CACACTCTGGA -> ACACTCTGGAC
ACACTCTGGAC -> CACTCTGGACC
CACTCTGGACC -> ACTCTGGACCT
ACTCTGGACCT -> CTCTGGACCTG
CTCTGGACCTG -> TCTGGACCTGG
TCTGGACCTGG -> CTGGACCTGGT
CTGGACCTGGT -> TGGACCTGGTG
TGGACCTGGTG -> GGACCTGGTGG
GGACCTGGTGG -> GACCTGGTGGC
GACCTGGTGGC -> ACCTGGTGGCC
ACCTGGTGGCC -> CCTGGTGGCCG
CCTGGTGGCCG -> CTGGTGGCCGT
CTGGTGGCCGT -> TGGTGGCCGTT
TGGTGGCCGTT -> GGTGGCCGTTT
GGTGGCCGTTT -> GTGGCCGTTTG
GTGGCCGTTTG -> TGGCCGTTTGT
TGGCCGTTTGT -> GGCCGTTTGTC
GGCCGTTTGTC -> GCCGTTTGTCA
GCCGTTTGTCA -> CCGTTTGTCAG
CCGTTTGTCAG -> CGTTTGTCAGG
CGTTTGTCAGG -> GTTTGTCAGGA
GTTTGTCAGGA -> TTTGTCAGGAC
TTTGTCAGGAC -> TTGTCAGGACG
TTGTCAGGACG -> TGTCAGGACGC
TGTCAGGACGC -> GTCAGGACGCG
GTCAGGACGCG -> TCAGGACGCGT
TCAGGACGCGT -> CAGGACGCGTT
CAGGACGCGTT -> AGGACGCGTTT
AGGACGCGTTT -> GGACGCGTTTG
GGACGCGTTTG -> GACGCGTTTGA
GACGCGTTTGA -> ACGCGTTTGAG
ACGCGTTTGAG -> CGCGTTTGAGC
CGCGTTTGAGC -> GCGTTTGAGCG
GCGTTTGAGCG -> CGTTTGAGCGA
CGTTTGAGCGA -> GTTTGAGCGAA
GTTTGAGCGAA -> TTTGAGCGAAC
TTTGAGCGAAC -> TTGAGCGAACA
TTGAGCGAACA -> TGAGCGAACAC
TGAGCGAACAC -> GAGCGAACACA
GAGCGAACACA -> AGCGAACACAT
AGCGAACACAT -> GCGAACACATT
GCGAACACATT -> CGAACACATTT
CGAACACATTT -> GAACACATTTC
GAACACATTTC -> AACACATTTCT
AACACATTTCT -> ACACATTTCTA
ACACATTTCTA -> CACATTTCTAC
CACATTTCTAC -> ACATTTCTACC
ACATTTCTACC -> CATTTCTACCT
CATTTCTACCT -> ATTTCTACCTT
ATTTCTACCTT -> TTTCTACCTTG
TTTCTACCTTG -> TTCTACCTTGG
TTCTACCTTGG -> TCTACCTTGGT
TCTACCTTGGT -> CTACCTTGGTG
CTACCTTGGTG -> TACCTTGGTGT
TACCTTGGTGT -> ACCTTGGTGTC
ACCTTGGTGTC -> CCTTGGTGTCC
CCTTGGTGTCC -> CTTGGTGTCCG
CTTGGTGTCCG -> TTGGTGTCCGA
TTGGTGTCCGA -> TGGTGTCCGAG
TGGTGTCCGAG -> GGTGTCCGAGA
GGTGTCCGAGA -> GTGTCCGAGAA
GTGTCCGAGAA -> TGTCCGAGAAT
TGTCCGAGAAT -> GTCCGAGAATA
GTCCGAGAATA -> TCCGAGAATAG
TCCGAGAATAG -> CCGAGAATAGA
CCGAGAATAGA -> CGAGAATAGAG
CGAGAATAGAG -> GAGAATAGAGG
GAGAATAGAGG -> AGAATAGAGGA
AGAATAGAGGA -> GAATAGAGGAT
GAATAGAGGAT -> AATAGAGGATT
AATAGAGGATT -> ATAGAGGATTC
ATAGAGGATTC -> TAGAGGATTCG
TAGAGGATTCG -> AGAGGATTCGA
AGAGGATTCGA -> GAGGATTCGAA
GAGGATTCGAA -> AGGATTCGAAG
AGGATTCGAAG -> GGATTCGAAGG
GGATTCGAAGG -> GATTCGAAGGG
GATTCGAAGGG -> ATTCGAAGGGC
ATTCGAAGGGC -> TTCGAAGGGCA
TTCGAAGGGCA -> TCGAAGGGCAG
TCGAAGGGCAG -> CGAAGGGCAGG
CGAAGGGCAGG -> GAAGGGCAGGA
GAAGGGCAGGA -> AAGGGCAGGAC
AAGGGCAGGAC -> AGGGCAGGACA
AGGGCAGGACA -> GGGCAGGACAC
GGGCAGGACAC -> GGCAGGACACA
GGCAGGACACA -> GCAGGACACAG
GCAGGACACAG -> CAGGACACAGA
CAGGACACAGA -> AGGACACAGAA
AGGACACAGAA -> GGACACAGAAC
GGACACAGAAC -> GACACAGAACC
GACACAGAACC -> ACACAGAACCG
ACACAGAACCG -> CACAGAACCGT
CACAGAACCGT -> ACAGAACCGTG
ACAGAACCGTG -> CAGAACCGTGT
CAGAACCGTGT -> AGAACCGTGTG
AGAACCGTGTG -> GAACCGTGTGC
GAACCGTGTGC -> AACCGTGTGCA
AACCGTGTGCA -> ACCGTGTGCAC
ACCGTGTGCAC -> CCGTGTGCACG
CCGTGTGCACG -> CGTGTGCACGT
CGTGTGCACGT -> GTGTGCACGTG
GTGTGCACGTG -> TGTGCACGTGT
TGTGCACGTGT -> GTGCACGTGTA
GTGCACGTGTA -> TGCACGTGTAT
TGCACGTGTAT -> GCACGTGTATT
GCACGTGTATT -> CACGTGTATTC
CACGTGTATTC -> ACGTGTATTCG
ACGTGTATTCG -> CGTGTATTCGC
CGTGTATTCGC -> GTGTATTCGCG
GTGTATTCGCG -> TGTATTCGCGG
TGTATTCGCGG -> GTATTCGCGGG
GTATTCGCGGG -> TATTCGCGGGG
TATTCGCGGGG -> ATTCGCGGGGT
ATTCGCGGGGT -> TTCGCGGGGTG
TTCGCGGGGTG -> TCGCGGGGTGC
TCGCGGGGTGC -> CGCGGGGTGCG
CGCGGGGTGCG -> GCGGGGTGCGC
GCGGGGTGCGC -> CGGGGTGCGCA
CGGGGTGCGCA -> GGGGTGCGCAT
GGGGTGCGCAT -> GGGTGCGCATA
GGGTGCGCATA -> GGTGCGCATAG
GGTGCGCATAG -> GTGCGCATAGA
GTGCGCATAGA -> TGCGCATAGAA
TGCGCATAGAA -> GCGCATAGAAT
GCGCATAGAAT -> CGCATAGAATT
CGCATAGAATT -> GCATAGAATTC
GCATAGAATTC -> CATAGAATTCC
CATAGAATTCC -> ATAGAATTCCT
ATAGAATTCCT -> TAGAATTCCTT
TAGAATTCCTT -> AGAATTCCTTT
AGAATTCCTTT -> GAATTCCTTTG
GAATTCCTTTG -> AATTCCTTTGG
AATTCCTTTGG -> ATTCCTTTGGC
ATTCCTTTGGC -> TTCCTTTGGCG
TTCCTTTGGCG -> TCCTTTGGCGT
TCCTTTGGCGT -> CCTTTGGCGTT
CCTTTGGCGTT -> CTTTGGCGTTC
CTTTGGCGTTC -> TTTGGCGTTCG
TTTGGCGTTCG -> TTGGCGTTCGA
TTGGCGTTCGA -> TGGCGTTCGAC
TGGCGTTCGAC -> GGCGTTCGACG
GGCGTTCGACG -> GCGTTCGACGA
GCGTTCGACGA -> CGTTCGACGAC
CGTTCGACGAC -> GTTCGACGACT
GTTCGACGACT -> TTCGACGACTT
TTCGACGACTT -> TCGACGACTTC
TCGACGACTTC -> CGACGACTTCA
CGACGACTTCA -> GACGACTTCAC
GACGACTTCAC -> ACGACTTCACG
ACGACTTCACG -> CGACTTCACGC
CGACTTCACGC -> GACTTCACGCA
GACTTCACGCA -> ACTTCACGCAT
ACTTCACGCAT -> CTTCACGCATG
CTTCACGCATG -> TTCACGCATGG
TTCACGCATGG -> TCACGCATGGA
TCACGCATGGA -> CACGCATGGAC
CACGCATGGAC -> ACGCATGGACT
ACGCATGGACT -> CGCATGGACTA
CGCATGGACTA -> GCATGGACTAA
GCATGGACTAA -> CATGGACTAAG
CATGGACTAAG -> ATGGACTAAGC
ATGGACTAAGC -> TGGACTAAGCT
TGGACTAAGCT -> GGACTAAGCTG
GGACTAAGCTG -> GACTAAGCTGA
GACTAAGCTGA -> ACTAAGCTGAT
ACTAAGCTGAT -> CTAAGCTGATT
CTAAGCTGATT -> TAAGCTGATTT
TAAGCTGATTT -> AAGCTGATTTT
AAGCTGATTTT -> AGCTGATTTTA
AGCTGATTTTA -> GCTGATTTTAA
GCTGATTTTAA -> CTGATTTTAAT
CTGATTTTAAT -> TGATTTTAATC
TGATTTTAATC -> GATTTTAATCT
GATTTTAATCT -> ATTTTAATCTG
ATTTTAATCTG -> TTTTAATCTGC
TTTTAATCTGC -> TTTAATCTGCC
TTTAATCTGCC -> TTAATCTGCCT
TTAATCTGCCT -> TAATCTGCCTC
TAATCTGCCTC -> AATCTGCCTCA
AATCTGCCTCA -> ATCTGCCTCAA
ATCTGCCTCAA -> TCTGCCTCAAA
TCTGCCTCAAA -> CTGCCTCAAAA
CTGCCTCAAAA -> TGCCTCAAAAT
TGCCTCAAAAT -> GCCTCAAAATT
GCCTCAAAATT -> CCTCAAAATTG
CCTCAAAATTG -> CTCAAAATTGC
CTCAAAATTGC -> TCAAAATTGCG
TCAAAATTGCG -> CAAAATTGCGA
CAAAATTGCGA -> AAAATTGCGAC
AAAATTGCGAC -> AAATTGCGACA
AAATTGCGACA -> AATTGCGACAG
AATTGCGACAG -> ATTGCGACAGG
ATTGCGACAGG -> TTGCGACAGGA
TTGCGACAGGA -> TGCGACAGGAA
TGCGACAGGAA -> GCGACAGGAAC
GCGACAGGAAC -> CGACAGGAACA
CGACAGGAACA -> GACAGGAACAA
GACAGGAACAA -> ACAGGAACAAA
ACAGGAACAAA -> CAGGAACAAAG
CAGGAACAAAG -> AGGAACAAAGC
AGGAACAAAGC -> GGAACAAAGCG
GGAACAAAGCG -> GAACAAAGCGC
GAACAAAGCGC -> AACAAAGCGCA
AACAAAGCGCA -> ACAAAGCGCAC
ACAAAGCGCAC -> CAAAGCGCACC
CAAAGCGCACC -> AAAGCGCACCA
AAAGCGCACCA -> AAGCGCACCAA
AAGCGCACCAA -> AGCGCACCAAC
AGCGCACCAAC -> GCGCACCAACC
GCGCACCAACC -> CGCACCAACCG
CGCACCAACCG -> GCACCAACCGA
GCACCAACCGA -> CACCAACCGAG
CACCAACCGAG -> ACCAACCGAGG
ACCAACCGAGG -> CCAACCGAGGA
CCAACCGAGGA -> CAACCGAGGAC
CAACCGAGGAC -> AACCGAGGACA
AACCGAGGACA -> ACCGAGGACAC
ACCGAGGACAC -> CCGAGGACACG
CCGAGGACACG -> CGAGGACACGT
CGAGGACACGT -> GAGGACACGTT
GAGGACACGTT -> AGGACACGTTA
AGGACACGTTA -> GGACACGTTAA
GGACACGTTAA -> GACACGTTAAA
GACACGTTAAA -> ACACGTTAAAT
ACACGTTAAAT -> CACGTTAAATC
CACGTTAAATC -> ACGTTAAATCG
ACGTTAAATCG -> CGTTAAATCGC
CGTTAAATCGC -> GTTAAATCGCG
GTTAAATCGCG -> TTAAATCGCGA
TTAAATCGCGA -> TAAATCGCGAA
TAAATCGCGAA -> AAATCGCGAAG
AAATCGCGAAG -> AATCGCGAAGC
AATCGCGAAGC -> ATCGCGAAGCT
ATCGCGAAGCT -> TCGCGAAGCTT
TCGCGAAGCTT -> CGCGAAGCTTG
CGCGAAGCTTG -> GCGAAGCTTGG
GCGAAGCTTGG -> CGAAGCTTGGG
CGAAGCTTGGG -> GAAGCTTGGGG
GAAGCTTGGGG -> AAGCTTGGGGT
AAGCTTGGGGT -> AGCTTGGGGTT
AGCTTGGGGTT -> GCTTGGGGTTT
GCTTGGGGTTT -> CTTGGGGTTTC
CTTGGGGTTTC -> TTGGGGTTTCT
TTGGGGTTTCT -> TGGGGTTTCTG
TGGGGTTTCTG -> GGGGTTTCTGT
GGGGTTTCTGT -> GGGTTTCTGTA
GGGTTTCTGTA -> GGTTTCTGTAA
GGTTTCTGTAA -> GTTTCTGTAAT
GTTTCTGTAAT -> TTTCTGTAATA
TTTCTGTAATA -> TTCTGTAATAC
TTCTGTAATAC -> TCTGTAATACG
TCTGTAATACG -> CTGTAATACGG
CTGTAATACGG -> TGTAATACGGT
TGTAATACGGT -> GTAATACGGTC
GTAATACGGTC -> TAATACGGTCG
TAATACGGTCG -> AATACGGTCGA
AATACGGTCGA -> ATACGGTCGAT
ATACGGTCGAT -> TACGGTCGATA
TACGGTCGATA -> ACGGTCGATAG
ACGGTCGATAG -> CGGTCGATAGC
CGGTCGATAGC -> GGTCGATAGCG
GGTCGATAGCG -> GTCGATAGCGG
GTCGATAGCGG -> TCGATAGCGGA
TCGATAGCGGA -> CGATAGCGGAT
CGATAGCGGAT -> GATAGCGGATA
GATAGCGGATA -> ATAGCGGATAT
ATAGCGGATAT -> TAGCGGATATA
TAGCGGATATA -> AGCGGATATAC
AGCGGATATAC -> GCGGATATACA
GCGGATATACA -> CGGATATACAG
CGGATATACAG -> GGATATACAGA
GGATATACAGA -> GATATACAGAA
GATATACAGAA -> ATATACAGAAA
ATATACAGAAA -> TATACAGAAAT
TATACAGAAAT -> ATACAGAAATC
ATACAGAAATC -> TACAGAAATCG
TACAGAAATCG -> ACAGAAATCGC
ACAGAAATCGC -> CAGAAATCGCG
CAGAAATCGCG -> AGAAATCGCGG
AGAAATCGCGG -> GAAATCGCGGA
GAAATCGCGGA -> AAATCGCGGAT
AAATCGCGGAT -> AATCGCGGATT
AATCGCGGATT -> ATCGCGGATTT
ATCGCGGATTT -> TCGCGGATTTC
TCGCGGATTTC -> CGCGGATTTCG
CGCGGATTTCG -> GCGGATTTCGT
GCGGATTTCGT -> CGGATTTCGTT
CGGATTTCGTT -> GGATTTCGTTG
GGATTTCGTTG -> GATTTCGTTGA
GATTTCGTTGA -> ATTTCGTTGAG
ATTTCGTTGAG -> TTTCGTTGAGA
TTTCGTTGAGA -> TTCGTTGAGAT
TTCGTTGAGAT -> TCGTTGAGATA
TCGTTGAGATA -> CGTTGAGATAC
CGTTGAGATAC -> GTTGAGATACG
GTTGAGATACG -> TTGAGATACGA
TTGAGATACGA -> TGAGATACGAT
TGAGATACGAT -> GAGATACGATG
GAGATACGATG -> AGATACGATGT
AGATACGATGT -> GATACGATGTT
GATACGATGTT -> ATACGATGTTG
ATACGATGTTG -> TACGATGTTGG
TACGATGTTGG -> ACGATGTTGGC
ACGATGTTGGC -> CGATGTTGGCT
CGATGTTGGCT -> GATGTTGGCTT
GATGTTGGCTT -> ATGTTGGCTTA
ATGTTGGCTTA -> TGTTGGCTTAG
TGTTGGCTTAG -> GTTGGCTTAGC
GTTGGCTTAGC -> TTGGCTTAGCC
TTGGCTTAGCC -> TGGCTTAGCCA
TGGCTTAGCCA -> GGCTTAGCCAG
GGCTTAGCCAG -> GCTTAGCCAGT
GCTTAGCCAGT -> CTTAGCCAGTT
CTTAGCCAGTT -> TTAGCCAGTTT
TTAGCCAGTTT -> TAGCCAGTTTG
TAGCCAGTTTG -> AGCCAGTTTGG
AGCCAGTTTGG -> GCCAGTTTGGG
GCCAGTTTGGG -> CCAGTTTGGGA
CCAGTTTGGGA -> CAGTTTGGGAG
CAGTTTGGGAG -> AGTTTGGGAGA
AGTTTGGGAGA -> GTTTGGGAGAA
GTTTGGGAGAA -> TTTGGGAGAAT
TTTGGGAGAAT -> TTGGGAGAATC
TTGGGAGAATC -> TGGGAGAATCG
TGGGAGAATCG -> GGGAGAATCGC
GGGAGAATCGC -> GGAGAATCGCA
GGAGAATCGCA -> GAGAATCGCAG
GAGAATCGCAG -> AGAATCGCAGG
AGAATCGCAGG -> GAATCGCAGGA
GAATCGCAGGA -> AATCGCAGGAG
AATCGCAGGAG -> ATCGCAGGAGT
ATCGCAGGAGT -> TCGCAGGAGTA
TCGCAGGAGTA -> CGCAGGAGTAG
CGCAGGAGTAG -> GCAGGAGTAGG
GCAGGAGTAGG -> CAGGAGTAGGC
CAGGAGTAGGC -> AGGAGTAGGCT
AGGAGTAGGCT -> GGAGTAGGCTC
GGAGTAGGCTC -> GAGTAGGCTCA
GAGTAGGCTCA -> AGTAGGCTCAC
AGTAGGCTCAC -> GTAGGCTCACT
GTAGGCTCACT -> TAGGCTCACTC
TAGGCTCACTC -> AGGCTCACTCG
AGGCTCACTCG -> GGCTCACTCGT
GGCTCACTCGT -> GCTCACTCGTC
GCTCACTCGTC -> CTCACTCGTCC
CTCACTCGTCC -> TCACTCGTCCA
TCACTCGTCCA -> CACTCGTCCAA
CACTCGTCCAA -> ACTCGTCCAAA
ACTCGTCCAAA -> CTCGTCCAAAG
CTCGTCCAAAG -> TCGTCCAAAGA
TCGTCCAAAGA -> CGTCCAAAGAA
CGTCCAAAGAA -> GTCCAAAGAAG
GTCCAAAGAAG -> TCCAAAGAAGC
TCCAAAGAAGC -> CCAAAGAAGCC
CCAAAGAAGCC -> CAAAGAAGCCA
CAAAGAAGCCA -> AAAGAAGCCAC
AAAGAAGCCAC -> AAGAAGCCACA
AAGAAGCCACA -> AGAAGCCACAT
AGAAGCCACAT -> GAAGCCACATA
GAAGCCACATA -> AAGCCACATAT
AAGCCACATAT -> AGCCACATATT
AGCCACATATT -> GCCACATATTG
GCCACATATTG -> CCACATATTGT
CCACATATTGT -> CACATATTGTT
CACATATTGTT -> ACATATTGTTA
ACATATTGTTA -> CATATTGTTAT
CATATTGTTAT -> ATATTGTTATT
ATATTGTTATT -> TATTGTTATTA
TATTGTTATTA -> ATTGTTATTAA
ATTGTTATTAA -> TTGTTATTAAA
TTGTTATTAAA -> TGTTATTAAAA
TGTTATTAAAA -> GTTATTAAAAG
GTTATTAAAAG -> TTATTAAAAGG
TTATTAAAAGG -> TATTAAAAGGT
TATTAAAAGGT -> ATTAAAAGGTA
ATTAAAAGGTA -> TTAAAAGGTAA
TTAAAAGGTAA -> TAAAAGGTAAC
TAAAAGGTAAC -> AAAAGGTAACT
AAAAGGTAACT -> AAAGGTAACTC
AAAGGTAACTC -> AAGGTAACTCT
AAGGTAACTCT -> AGGTAACTCTA
AGGTAACTCTA -> GGTAACTCTAC
GGTAACTCTAC -> GTAACTCTACT
GTAACTCTACT -> TAACTCTACTT
TAACTCTACTT -> AACTCTACTTA
AACTCTACTTA -> ACTCTACTTAT
ACTCTACTTAT -> CTCTACTTATT
CTCTACTTATT -> TCTACTTATTG
TCTACTTATTG -> CTACTTATTGG
CTACTTATTGG -> TACTTATTGGC
TACTTATTGGC -> ACTTATTGGCG
ACTTATTGGCG -> CTTATTGGCGA
CTTATTGGCGA -> TTATTGGCGAG
TTATTGGCGAG -> TATTGGCGAGG
TATTGGCGAGG -> ATTGGCGAGGG
ATTGGCGAGGG -> TTGGCGAGGGC
TTGGCGAGGGC -> TGGCGAGGGCC
TGGCGAGGGCC -> GGCGAGGGCCA
GGCGAGGGCCA -> GCGAGGGCCAG
GCGAGGGCCAG -> CGAGGGCCAGA
CGAGGGCCAGA -> GAGGGCCAGAC
GAGGGCCAGAC -> AGGGCCAGACC
AGGGCCAGACC -> GGGCCAGACCT
GGGCCAGACCT -> GGCCAGACCTG
GGCCAGACCTG -> GCCAGACCTGG
GCCAGACCTGG -> CCAGACCTGGC
CCAGACCTGGC -> CAGACCTGGCC
CAGACCTGGCC -> AGACCTGGCCT
AGACCTGGCCT -> GACCTGGCCTG
GACCTGGCCTG -> ACCTGGCCTGT
ACCTGGCCTGT -> CCTGGCCTGTC
CCTGGCCTGTC -> CTGGCCTGTCA
CTGGCCTGTCA -> TGGCCTGTCAC
TGGCCTGTCAC -> GGCCTGTCACT
GGCCTGTCACT -> GCCTGTCACTA
GCCTGTCACTA -> CCTGTCACTAT
CCTGTCACTAT -> CTGTCACTATC
CTGTCACTATC -> TGTCACTATCG
TGTCACTATCG -> GTCACTATCGA
GTCACTATCGA -> TCACTATCGAG
TCACTATCGAG -> CACTATCGAGT
CACTATCGAGT -> ACTATCGAGTA
ACTATCGAGTA -> CTATCGAGTAA
CTATCGAGTAA -> TATCGAGTAAT
TATCGAGTAAT -> ATCGAGTAATA
ATCGAGTAATA -> TCGAGTAATAT
TCGAGTAATAT -> CGAGTAATATA
CGAGTAATATA -> GAGTAATATAT
GAGTAATATAT -> AGTAATATATA
AGTAATATATA -> GTAATATATAG
GTAATATATAG -> TAATATATAGT
TAATATATAGT -> AATATATAGTT
AATATATAGTT -> ATATATAGTTT
ATATATAGTTT -> TATATAGTTTT
TATATAGTTTT -> ATATAGTTTTG
ATATAGTTTTG -> TATAGTTTTGA
TATAGTTTTGA -> ATAGTTTTGAT
ATAGTTTTGAT -> TAGTTTTGATA
TAGTTTTGATA -> AGTTTTGATAA
AGTTTTGATAA -> GTTTTGATAAT
GTTTTGATAAT -> TTTTGATAATA
TTTTGATAATA -> TTTGATAATAA
TTTGATAATAA -> TTGATAATAAC
TTGATAATAAC -> TGATAATAACG
TGATAATAACG -> GATAATAACGA
GATAATAACGA -> ATAATAACGAG
ATAATAACGAG -> TAATAACGAGT
TAATAACGAGT -> AATAACGAGTT
AATAACGAGTT -> ATAACGAGTTA
ATAACGAGTTA -> TAACGAGTTAA
TAACGAGTTAA -> AACGAGTTAAT
AACGAGTTAAT -> ACGAGTTAATA
ACGAGTTAATA -> CGAGTTAATAC
CGAGTTAATAC -> GAGTTAATACC
GAGTTAATACC -> AGTTAATACCA
AGTTAATACCA -> GTTAATACCAA
GTTAATACCAA -> TTAATACCAAC
TTAATACCAAC -> TAATACCAACC
TAATACCAACC -> AATACCAACCA
AATACCAACCA -> ATACCAACCAT
ATACCAACCAT -> TACCAACCATC
TACCAACCATC -> ACCAACCATCG
ACCAACCATCG -> CCAACCATCGG
CCAACCATCGG -> CAACCATCGGA
CAACCATCGGA -> AACCATCGGAT
AACCATCGGAT -> ACCATCGGATC
ACCATCGGATC -> CCATCGGATCC
CCATCGGATCC -> CATCGGATCCA
CATCGGATCCA -> ATCGGATCCAA
ATCGGATCCAA -> TCGGATCCAAT
TCGGATCCAAT -> CGGATCCAATG
CGGATCCAATG -> GGATCCAATGG
GGATCCAATGG -> GATCCAATGGG
GATCCAATGGG -> ATCCAATGGGA
ATCCAATGGGA -> TCCAATGGGAT
TCCAATGGGAT -> CCAATGGGATA
CCAATGGGATA -> CAATGGGATAT
CAATGGGATAT -> AATGGGATATA
AATGGGATATA -> ATGGGATATAC
ATGGGATATAC -> TGGGATATACT
TGGGATATACT -> GGGATATACTA
GGGATATACTA -> GGATATACTAT
GGATATACTAT -> GATATACTATG
GATATACTATG -> ATATACTATGG
ATATACTATGG -> TATACTATGGA
TATACTATGGA -> ATACTATGGAT
ATACTATGGAT -> TACTATGGATG
TACTATGGATG -> ACTATGGATGA
ACTATGGATGA -> CTATGGATGAC
CTATGGATGAC -> TATGGATGACG
TATGGATGACG -> ATGGATGACGG
ATGGATGACGG -> TGGATGACGGG
TGGATGACGGG -> GGATGACGGGT
GGATGACGGGT -> GATGACGGGTC
GATGACGGGTC -> ATGACGGGTCC
ATGACGGGTCC -> TGACGGGTCCG
TGACGGGTCCG -> GACGGGTCCGT
GACGGGTCCGT -> ACGGGTCCGTA
ACGGGTCCGTA -> CGGGTCCGTAC
CGGGTCCGTAC -> GGGTCCGTACT
GGGTCCGTACT -> GGTCCGTACTG
GGTCCGTACTG -> GTCCGTACTGG
GTCCGTACTGG -> TCCGTACTGGC
TCCGTACTGGC -> CCGTACTGGCA
CCGTACTGGCA -> CGTACTGGCAT
CGTACTGGCAT -> GTACTGGCATC
GTACTGGCATC -> TACTGGCATCA
TACTGGCATCA -> ACTGGCATCAC
ACTGGCATCAC -> CTGGCATCACG
CTGGCATCACG -> TGGCATCACGG
TGGCATCACGG -> GGCATCACGGA
GGCATCACGGA -> GCATCACGGAC
GCATCACGGAC -> CATCACGGACT
CATCACGGACT -> ATCACGGACTG
ATCACGGACTG -> TCACGGACTGG
TCACGGACTGG -> CACGGACTGGT
CACGGACTGGT -> ACGGACTGGTT
ACGGACTGGTT -> CGGACTGGTTA
CGGACTGGTTA -> GGACTGGTTAA
GGACTGGTTAA -> GACTGGTTAAC
GACTGGTTAAC -> ACTGGTTAACT
ACTGGTTAACT -> CTGGTTAACTT
CTGGTTAACTT -> TGGTTAACTTG
TGGTTAACTTG -> GGTTAACTTGT
GGTTAACTTGT -> GTTAACTTGTA
GTTAACTTGTA -> TTAACTTGTAT
TTAACTTGTAT -> TAACTTGTATG
TAACTTGTATG -> AACTTGTATGC
AACTTGTATGC -> ACTTGTATGCC
ACTTGTATGCC -> CTTGTATGCCA
CTTGTATGCCA -> TTGTATGCCAT
TTGTATGCCAT -> TGTATGCCATC
TGTATGCCATC -> GTATGCCATCA
GTATGCCATCA -> TATGCCATCAC
TATGCCATCAC -> ATGCCATCACC
ATGCCATCACC -> TGCCATCACCA
TGCCATCACCA -> GCCATCACCAT
GCCATCACCAT -> CCATCACCATC
CCATCACCATC -> CATCACCATCT
CATCACCATCT -> ATCACCATCTC
ATCACCATCTC -> TCACCATCTCT
TCACCATCTCT -> CACCATCTCTG
CACCATCTCTG -> ACCATCTCTGC
ACCATCTCTGC -> CCATCTCTGCC
CCATCTCTGCC -> CATCTCTGCCT
CATCTCTGCCT -> ATCTCTGCCTT
ATCTCTGCCTT -> TCTCTGCCTTC
TCTCTGCCTTC -> CTCTGCCTTCA
CTCTGCCTTCA -> TCTGCCTTCAG
TCTGCCTTCAG -> CTGCCTTCAGG
CTGCCTTCAGG -> TGCCTTCAGGT
TGCCTTCAGGT -> GCCTTCAGGTT
GCCTTCAGGTT -> CCTTCAGGTTC
CCTTCAGGTTC -> CTTCAGGTTCC
CTTCAGGTTCC -> TTCAGGTTCCA
TTCAGGTTCCA -> TCAGGTTCCAG
TCAGGTTCCAG -> CAGGTTCCAGT
CAGGTTCCAGT -> AGGTTCCAGTG
AGGTTCCAGTG -> GGTTCCAGTGT
GGTTCCAGTGT -> GTTCCAGTGTT
GTTCCAGTGTT -> TTCCAGTGTTC
TTCCAGTGTTC -> TCCAGTGTTCG
TCCAGTGTTCG -> CCAGTGTTCGA
CCAGTGTTCGA -> CAGTGTTCGAG
CAGTGTTCGAG -> AGTGTTCGAGC
AGTGTTCGAGC -> GTGTTCGAGCA
GTGTTCGAGCA -> TGTTCGAGCAA
TGTTCGAGCAA -> GTTCGAGCAAA
GTTCGAGCAAA -> TTCGAGCAAAA
TTCGAGCAAAA -> TCGAGCAAAAG
TCGAGCAAAAG -> CGAGCAAAAGA
CGAGCAAAAGA -> GAGCAAAAGAT
GAGCAAAAGAT -> AGCAAAAGATG
AGCAAAAGATG -> GCAAAAGATGA
GCAAAAGATGA -> CAAAAGATGAA
CAAAAGATGAA -> AAAAGATGAAG
AAAAGATGAAG -> AAAGATGAAGC
AAAGATGAAGC -> AAGATGAAGCA
AAGATGAAGCA -> AGATGAAGCAG
AGATGAAGCAG -> GATGAAGCAGG
GATGAAGCAGG -> ATGAAGCAGGA
ATGAAGCAGGA -> TGAAGCAGGAG
TGAAGCAGGAG -> GAAGCAGGAGA
GAAGCAGGAGA -> AAGCAGGAGAG
AAGCAGGAGAG -> AGCAGGAGAGA
AGCAGGAGAGA -> GCAGGAGAGAT
GCAGGAGAGAT -> CAGGAGAGATG
CAGGAGAGATG -> AGGAGAGATGC
AGGAGAGATGC -> GGAGAGATGCA
GGAGAGATGCA -> GAGAGATGCAC
GAGAGATGCAC -> AGAGATGCACG
AGAGATGCACG -> GAGATGCACGC
GAGATGCACGC -> AGATGCACGCT
AGATGCACGCT -> GATGCACGCTT
GATGCACGCTT -> ATGCACGCTTC
ATGCACGCTTC -> TGCACGCTTCC
TGCACGCTTCC -> GCACGCTTCCA
GCACGCTTCCA -> CACGCTTCCAC
CACGCTTCCAC -> ACGCTTCCACA
ACGCTTCCACA -> CGCTTCCACAG
CGCTTCCACAG -> GCTTCCACAGT
GCTTCCACAGT -> CTTCCACAGTT
CTTCCACAGTT -> TTCCACAGTTA
TTCCACAGTTA -> TCCACAGTTAG
TCCACAGTTAG -> CCACAGTTAGA
CCACAGTTAGA -> CACAGTTAGAC
CACAGTTAGAC -> ACAGTTAGACC
ACAGTTAGACC -> CAGTTAGACCA
CAGTTAGACCA -> AGTTAGACCAT
AGTTAGACCAT -> GTTAGACCATT
GTTAGACCATT -> TTAGACCATTT
TTAGACCATTT -> TAGACCATTTA
TAGACCATTTA -> AGACCATTTAA
AGACCATTTAA -> GACCATTTAAC
GACCATTTAAC -> ACCATTTAACC
ACCATTTAACC -> CCATTTAACCA
CCATTTAACCA -> CATTTAACCAT
CATTTAACCAT -> ATTTAACCATT
ATTTAACCATT -> TTTAACCATTC
TTTAACCATTC -> TTAACCATTCG
TTAACCATTCG -> TAACCATTCGA
TAACCATTCGA -> AACCATTCGAT
AACCATTCGAT -> ACCATTCGATC
ACCATTCGATC -> CCATTCGATCG
CCATTCGATCG -> CATTCGATCGC
CATTCGATCGC -> ATTCGATCGCT
ATTCGATCGCT -> TTCGATCGCTG
TTCGATCGCTG -> TCGATCGCTGA
TCGATCGCTGA -> CGATCGCTGAG
CGATCGCTGAG -> GATCGCTGAGG
GATCGCTGAGG -> ATCGCTGAGGT
ATCGCTGAGGT -> TCGCTGAGGTC
TCGCTGAGGTC -> CGCTGAGGTCC
CGCTGAGGTCC -> GCTGAGGTCCT
GCTGAGGTCCT -> CTGAGGTCCTT
CTGAGGTCCTT -> TGAGGTCCTTC
TGAGGTCCTTC -> GAGGTCCTTCA
GAGGTCCTTCA -> AGGTCCTTCAC
AGGTCCTTCAC -> GGTCCTTCACA
GGTCCTTCACA -> GTCCTTCACAG
GTCCTTCACAG -> TCCTTCACAGG
TCCTTCACAGG -> CCTTCACAGGT
CCTTCACAGGT -> CTTCACAGGTA
CTTCACAGGTA -> TTCACAGGTAA
TTCACAGGTAA -> TCACAGGTAAA
TCACAGGTAAA -> CACAGGTAAAA
CACAGGTAAAA -> ACAGGTAAAAA
ACAGGTAAAAA -> CAGGTAAAAAA
CAGGTAAAAAA -> AGGTAAAAAAG
AGGTAAAAAAG -> GGTAAAAAAGA
GGTAAAAAAGA -> GTAAAAAAGAC
GTAAAAAAGAC -> TAAAAAAGACA
TAAAAAAGACA -> AAAAAAGACAC
AAAAAAGACAC -> AAAAAGACACC
AAAAAGACACC -> AAAAGACACCA
AAAAGACACCA -> AAAGACACCAT
AAAGACACCAT -> AAGACACCATC
AAGACACCATC -> AGACACCATCT
AGACACCATCT -> GACACCATCTA
GACACCATCTA -> ACACCATCTAT
ACACCATCTAT -> CACCATCTATA
CACCATCTATA -> ACCATCTATAA
ACCATCTATAA -> CCATCTATAAG
CCATCTATAAG -> CATCTATAAGG
CATCTATAAGG -> ATCTATAAGGA
ATCTATAAGGA -> TCTATAAGGAC
TCTATAAGGAC -> CTATAAGGACC
CTATAAGGACC -> TATAAGGACCC
TATAAGGACCC -> ATAAGGACCCT
ATAAGGACCCT -> TAAGGACCCTC
TAAGGACCCTC -> AAGGACCCTCT
AAGGACCCTCT -> AGGACCCTCTG
AGGACCCTCTG -> GGACCCTCTGC
GGACCCTCTGC -> GACCCTCTGCC
GACCCTCTGCC -> ACCCTCTGCCA
ACCCTCTGCCA -> CCCTCTGCCAA
CCCTCTGCCAA -> CCTCTGCCAAG
CCTCTGCCAAG -> CTCTGCCAAGG
CTCTGCCAAGG -> TCTGCCAAGGG
TCTGCCAAGGG -> CTGCCAAGGGA
CTGCCAAGGGA -> TGCCAAGGGAC
TGCCAAGGGAC -> GCCAAGGGACG
GCCAAGGGACG -> CCAAGGGACGC
CCAAGGGACGC -> CAAGGGACGCT
CAAGGGACGCT -> AAGGGACGCTG
AAGGGACGCTG -> AGGGACGCTGT
AGGGACGCTGT -> GGGACGCTGTT
GGGACGCTGTT -> GGACGCTGTTC
GGACGCTGTTC -> GACGCTGTTCT
GACGCTGTTCT -> ACGCTGTTCTT
ACGCTGTTCTT -> CGCTGTTCTTG
CGCTGTTCTTG -> GCTGTTCTTGC
GCTGTTCTTGC -> CTGTTCTTGCG
CTGTTCTTGCG -> TGTTCTTGCGC
TGTTCTTGCGC -> GTTCTTGCGCA
GTTCTTGCGCA -> TTCTTGCGCAT
TTCTTGCGCAT -> TCTTGCGCATC
TCTTGCGCATC -> CTTGCGCATCT
CTTGCGCATCT -> TTGCGCATCTC
TTGCGCATCTC -> TGCGCATCTCC
TGCGCATCTCC -> GCGCATCTCCC
GCGCATCTCCC -> CGCATCTCCCA
CGCATCTCCCA -> GCATCTCCCAG
GCATCTCCCAG -> CATCTCCCAGT
CATCTCCCAGT -> ATCTCCCAGTG
ATCTCCCAGTG -> TCTCCCAGTGC
TCTCCCAGTGC -> CTCCCAGTGCC
CTCCCAGTGCC -> TCCCAGTGCCG
TCCCAGTGCCG -> CCCAGTGCCGA
CCCAGTGCCGA -> CCAGTGCCGAC
CCAGTGCCGAC -> CAGTGCCGACA
CAGTGCCGACA -> AGTGCCGACAG
AGTGCCGACAG -> GTGCCGACAGT
GTGCCGACAGT -> TGCCGACAGTT
TGCCGACAGTT -> GCCGACAGTTA
GCCGACAGTTA -> CCGACAGTTAA
CCGACAGTTAA -> CGACAGTTAAT
CGACAGTTAAT -> GACAGTTAATA
GACAGTTAATA -> ACAGTTAATAA
ACAGTTAATAA -> CAGTTAATAAT
CAGTTAATAAT -> AGTTAATAATA
AGTTAATAATA -> GTTAATAATAT
GTTAATAATAT -> TTAATAATATA
TTAATAATATA -> TAATAATATAC
TAATAATATAC -> AATAATATACG
AATAATATACG -> ATAATATACGG
ATAATATACGG -> TAATATACGGC
TAATATACGGC -> AATATACGGCG
AATATACGGCG -> ATATACGGCGC
ATATACGGCGC -> TATACGGCGCA
TATACGGCGCA -> ATACGGCGCAT
ATACGGCGCAT -> TACGGCGCATT
TACGGCGCATT -> ACGGCGCATTA
ACGGCGCATTA -> CGGCGCATTAA
CGGCGCATTAA -> GGCGCATTAAC
GGCGCATTAAC -> GCGCATTAACG
GCGCATTAACG -> CGCATTAACGT
CGCATTAACGT -> GCATTAACGTC
GCATTAACGTC -> CATTAACGTCT
CATTAACGTCT -> ATTAACGTCTG
ATTAACGTCTG -> TTAACGTCTGG
TTAACGTCTGG -> TAACGTCTGGG
TAACGTCTGGG -> AACGTCTGGGT
AACGTCTGGGT -> ACGTCTGGGTT
ACGTCTGGGTT -> CGTCTGGGTTG
CGTCTGGGTTG -> GTCTGGGTTGA
GTCTGGGTTGA -> TCTGGGTTGAC
TCTGGGTTGAC -> CTGGGTTGACG
CTGGGTTGACG -> TGGGTTGACGC
TGGGTTGACGC -> GGGTTGACGCA
GGGTTGACGCA -> GGTTGACGCAA
GGTTGACGCAA -> GTTGACGCAAC
GTTGACGCAAC -> TTGACGCAACG
TTGACGCAACG -> TGACGCAACGC
TGACGCAACGC -> GACGCAACGCC
GACGCAACGCC -> ACGCAACGCCT
ACGCAACGCCT -> CGCAACGCCTC
CGCAACGCCTC -> GCAACGCCTCT
GCAACGCCTCT -> CAACGCCTCTG
CAACGCCTCTG -> AACGCCTCTGT
AACGCCTCTGT -> ACGCCTCTGTC
ACGCCTCTGTC -> CGCCTCTGTCA
CGCCTCTGTCA -> GCCTCTGTCAT
GCCTCTGTCAT -> CCTCTGTCATT
CCTCTGTCATT -> CTCTGTCATTT
CTCTGTCATTT -> TCTGTCATTTA
TCTGTCATTTA -> CTGTCATTTAC
CTGTCATTTAC -> TGTCATTTACG
TGTCATTTACG -> GTCATTTACGT
GTCATTTACGT -> TCATTTACGTC
TCATTTACGTC -> CATTTACGTCC
CATTTACGTCC -> ATTTACGTCCA
ATTTACGTCCA -> TTTACGTCCAC
TTTACGTCCAC -> TTACGTCCACT
TTACGTCCACT -> TACGTCCACTT
TACGTCCACTT -> ACGTCCACTTA
ACGTCCACTTA -> CGTCCACTTAA
CGTCCACTTAA -> GTCCACTTAAT
GTCCACTTAAT -> TCCACTTAATT
TCCACTTAATT -> CCACTTAATTG
CCACTTAATTG -> CACTTAATTGC
CACTTAATTGC -> ACTTAATTGCT
ACTTAATTGCT -> CTTAATTGCTT
CTTAATTGCTT -> TTAATTGCTTG
TTAATTGCTTG -> TAATTGCTTGT
TAATTGCTTGT -> AATTGCTTGTG
AATTGCTTGTG -> ATTGCTTGTGC
ATTGCTTGTGC -> TTGCTTGTGCC
TTGCTTGTGCC -> TGCTTGTGCCT
TGCTTGTGCCT -> GCTTGTGCCTT
GCTTGTGCCTT -> CTTGTGCCTTA
CTTGTGCCTTA -> TTGTGCCTTAT
TTGTGCCTTAT -> TGTGCCTTATA
TGTGCCTTATA -> GTGCCTTATAG
GTGCCTTATAG -> TGCCTTATAGA
TGCCTTATAGA -> GCCTTATAGAT
CCTTATAGATA -> CTTATAGATAC
CTTATAGATAC -> TTATAGATACA
TTATAGATACA -> TATAGATACAG
TATAGATACAG -> ATAGATACAGA
ATAGATACAGA -> TAGATACAGAT
TAGATACAGAT -> AGATACAGATG
AGATACAGATG -> GATACAGATGT
GATACAGATGT -> ATACAGATGTA
ATACAGATGTA -> TACAGATGTAC
TACAGATGTAC -> ACAGATGTACA
ACAGATGTACA -> CAGATGTACAC
CAGATGTACAC -> AGATGTACACT
AGATGTACACT -> GATGTACACTC
GATGTACACTC -> ATGTACACTCG
ATGTACACTCG -> TGTACACTCGA
TGTACACTCGA -> GTACACTCGAG
GTACACTCGAG -> TACACTCGAGG
TACACTCGAGG -> ACACTCGAGGA
ACACTCGAGGA -> CACTCGAGGAT
CACTCGAGGAT -> ACTCGAGGATA
ACTCGAGGATA -> CTCGAGGATAT
CTCGAGGATAT -> TCGAGGATATT
TCGAGGATATT -> CGAGGATATTA
CGAGGATATTA -> GAGGATATTAG
GAGGATATTAG -> AGGATATTAGC
AGGATATTAGC -> GGATATTAGCT
GGATATTAGCT -> GATATTAGCTT
GATATTAGCTT -> ATATTAGCTTG
ATATTAGCTTG -> TATTAGCTTGT
TATTAGCTTGT -> ATTAGCTTGTA
ATTAGCTTGTA -> TTAGCTTGTAA
TTAGCTTGTAA -> TAGCTTGTAAT
TAGCTTGTAAT -> AGCTTGTAATA
AGCTTGTAATA -> GCTTGTAATAG
GCTTGTAATAG -> CTTGTAATAGT
CTTGTAATAGT -> TTGTAATAGTA
TTGTAATAGTA -> TGTAATAGTAA
TGTAATAGTAA -> GTAATAGTAAC
GTAATAGTAAC -> TAATAGTAACA
TAATAGTAACA -> AATAGTAACAA
AATAGTAACAA -> ATAGTAACAAT
ATAGTAACAAT -> TAGTAACAATA
TAGTAACAATA -> AGTAACAATAA
AGTAACAATAA -> GTAACAATAAA
GTAACAATAAA -> TAACAATAAAT
TAACAATAAAT -> AACAATAAATA
AACAATAAATA -> ACAATAAATAG
ACAATAAATAG -> CAATAAATAGT
CAATAAATAGT -> AATAAATAGTC
AATAAATAGTC -> ATAAATAGTCC
ATAAATAGTCC -> TAAATAGTCCC
TAAATAGTCCC -> AAATAGTCCCT
AAATAGTCCCT -> AATAGTCCCTA
AATAGTCCCTA -> ATAGTCCCTAG
ATAGTCCCTAG -> TAGTCCCTAGC
TAGTCCCTAGC -> AGTCCCTAGCG
AGTCCCTAGCG -> GTCCCTAGCGT
GTCCCTAGCGT -> TCCCTAGCGTA
TCCCTAGCGTA -> CCCTAGCGTAT
CCCTAGCGTAT -> CCTAGCGTATG
CCTAGCGTATG -> CTAGCGTATGG
CTAGCGTATGG -> TAGCGTATGGG
TAGCGTATGGG -> AGCGTATGGGA
AGCGTATGGGA -> GCGTATGGGAT
GCGTATGGGAT -> CGTATGGGATA
CGTATGGGATA -> GTATGGGATAT
GTATGGGATAT -> TATGGGATATG
TATGGGATATG -> ATGGGATATGG
ATGGGATATGG -> TGGGATATGGG
TGGGATATGGG -> GGGATATGGGC
GGGATATGGGC -> GGATATGGGCT
GGATATGGGCT -> GATATGGGCTG
GATATGGGCTG -> ATATGGGCTGC
ATATGGGCTGC -> TATGGGCTGCA
TATGGGCTGCA -> ATGGGCTGCAC
ATGGGCTGCAC -> TGGGCTGCACT
TGGGCTGCACT -> GGGCTGCACTC
GGGCTGCACTC -> GGCTGCACTCA
GGCTGCACTCA -> GCTGCACTCAA
GCTGCACTCAA -> CTGCACTCAAT
CTGCACTCAAT -> TGCACTCAATT
TGCACTCAATT -> GCACTCAATTA
GCACTCAATTA -> CACTCAATTAT
CACTCAATTAT -> ACTCAATTATT
ACTCAATTATT -> CTCAATTATTC
CTCAATTATTC -> TCAATTATTCA
TCAATTATTCA -> CAATTATTCAA
CAATTATTCAA -> AATTATTCAAA
AATTATTCAAA -> ATTATTCAAAA
ATTATTCAAAA -> TTATTCAAAAA
TTATTCAAAAA -> TATTCAAAAAG
TATTCAAAAAG -> ATTCAAAAAGG
ATTCAAAAAGG -> TTCAAAAAGGA
TTCAAAAAGGA -> TCAAAAAGGAA
TCAAAAAGGAA -> CAAAAAGGAAC
CAAAAAGGAAC -> AAAAAGGAACA
AAAAAGGAACA -> AAAAGGAACAA
AAAAGGAACAA -> AAAGGAACAAT
AAAGGAACAAT -> AAGGAACAATT
AAGGAACAATT -> AGGAACAATTG
AGGAACAATTG -> GGAACAATTGT
GGAACAATTGT -> GAACAATTGTG
GAACAATTGTG -> AACAATTGTGG
AACAATTGTGG -> ACAATTGTGGC
ACAATTGTGGC -> CAATTGTGGCG
CAATTGTGGCG -> AATTGTGGCGG
AATTGTGGCGG -> ATTGTGGCGGT
ATTGTGGCGGT -> TTGTGGCGGTC
TTGTGGCGGTC -> TGTGGCGGTCT
TGTGGCGGTCT -> GTGGCGGTCTT
GTGGCGGTCTT -> TGGCGGTCTTA
TGGCGGTCTTA -> GGCGGTCTTAC
GGCGGTCTTAC -> GCGGTCTTACA
GCGGTCTTACA -> CGGTCTTACAG
CGGTCTTACAG -> GGTCTTACAGG
GGTCTTACAGG -> GTCTTACAGGA
GTCTTACAGGA -> TCTTACAGGAG
TCTTACAGGAG -> CTTACAGGAGA
CTTACAGGAGA -> TTACAGGAGAA
TTACAGGAGAA -> TACAGGAGAAT
TACAGGAGAAT -> ACAGGAGAATC
ACAGGAGAATC -> CAGGAGAATCG
CAGGAGAATCG -> AGGAGAATCGG
AGGAGAATCGG -> GGAGAATCGGG
GGAGAATCGGG -> GAGAATCGGGA
GAGAATCGGGA -> AGAATCGGGAG
AGAATCGGGAG -> GAATCGGGAGA
GAATCGGGAGA -> AATCGGGAGAG
AATCGGGAGAG -> ATCGGGAGAGA
ATCGGGAGAGA -> TCGGGAGAGAC
TCGGGAGAGAC -> CGGGAGAGACC
